Wot, Wot, Wwt, Wot, Wwt, Wwt, Wwt, Wwt, Wwt, Wot, Wwt, Wot, Wot, Wot, Wot, Wot, Wot, Wot, Wot, Wot, Wot, Wot, Wot, Wot
Wot, Wwt, Wwrt, Wwt, Wwrt, Wwrt, Wwrt, Wwt, Ds, Wwrt, Wwrt, Wwt, Wwt, Wot, Wot, Wot, Wot, Wot, Wot, Wot, Wot, Wot, Wot, Wot
Wot, Wwt, Ds, Dd^Vdt, Dd^Ftd, Mdd, Dd^Ftd, Ds, Gs^Ft, Mdd, Gs^Ftp, Ds, Wwrt, Wwt, Wwt, Wot, Wwt, Wot, Wwt, Wot, Wwt, Wot, Wot, Wot
Wwt, Wwrt, Gs^Ft, Gs^Ftp, Gll^Ftr, Gs^Ft, Gs^Ft, Gs^Ft, Dd^Ftd, Gs^Ft, Dd^Vda, Ds, Wwrt, Wwt, Wwt, Wwt, Wwrt, Wwt, Dd^Ftd, Wwt, Wwrt, Wwt, Wwt, Wot
Wwt, Ds, Dd^Ftd, Gs^Ftp, Mdd, Gs^Ft, Dd^Ftd, Ds, Wwrt, Ds, Ds, Wwrt, Wwt, Wwrt, Wwt, Wwrt, Ds, Wwrt, Gs^Ftp, Gs^Ftp, Dd^Vda, Wwrt, Wwt, Wot
Wot, Wwrt, Ds, Ds, Wwrt, Dd^Vda, Ds, Ds, Wwrt, Wwrt, Wwt, Wwrt, Wwt, Wwt, Wwt, Wwt, Wwrt, Dd^Ftd, Md, Mv, Md, Dd^Ftd, Wwrt, Wwt
Wot, Wwt, Wwt, Wwrt, Wwt, Wwt, Wwrt, Wwt, Wwt, Wwt, Wwt, Ds, Wwrt, Wwt, Wwrt, Wwt, Wwt, Ds, Ds, Md, Gs^Ftp, Gs^Ftp, Wwrt, Dd
Wot, Wot, Wot, Wwt, Wwt, Wwt, Wwt, Ds, Wwrt, Wwrt, Ds, Wwrt, Wwt, Ds, Ds, Wwt, Wwt, Wwrt, Wwt, Wwrt, Ds, Dd^Ftd, Wwt, Wwt
Wot, Wot, Wot, Wot, Wwt, Wwt, Wwrt, Wwt, Dd^Ftd, Wwrt, Wwrt, Wwt, Wwrt, Wwrt, Wwt, Wwrt, Wwrt, Wwt, Wwt, Wwt, Wwrt, Wwt, Wwrt, Wwt
Wot, Wot, Wwt, Wwt, Wwrt, Ds, Dd^Ftd, Wwrt, Ds, Wwt, Wwrt, Wwt, Wwt, Wwrt, Wwt, Dd^Ftd, Dd^Ftd, Wwrt, Ds, Wwt, Wwt, Wwt, Ds, Dd^Ftd
Wot, Wwt, Ds, Dd^Ftd, Gs^Ft, Mdd, Gs^Ft, Ds, Wwrt, Wwt, Wwt, Wwt, Wwrt, Wwt, Wwt, Wwrt, Mdd, Gs^Ft, Dd^Ftd, Wwrt, Wwt, Wwrt, Wwt, Ds
Wot, Wwt, Ds, Gs^Ft, Gll^Ftr, Gll^Ftr, Gll^Ftr, Gs^Ft, Dd^Vda, Wwrt, Ds, Wwrt, Wwrt, Ce, Ce, Wwrt, Gll^Ftr, Gs^Ft, Dd^Ftd, Ds, Wwt, Wwt, Wwt, Wwt
Wot, Wwt, Wwt, Dd^Ftd, Dd^Vda, Gs^Ftp, Gll^Ftr, Gll^Ftr, Gll^Ftr, Gs^Ft, Gs^Ft, Dd^Ftd, Gs^Ft, Ket, Gs^Ft, Gs^Ftp, Gs^Ft, Gs^Ft, Ds, Wwt, Wwrt, Wwrt, Wwt, Wwt
Wot, Wot, Wwt, Ds, Wwrt, Dd^Ftd, Mdd, Gs^Ftp, Dd^Ftd, Gs^Ft, Gs^Ftp, Gs^Ftp, Gs^Ftp, Gll^Ftr, Gs^Ft, Gs^Ftp, Dd^Ftd, Dd^Vda, Wwrt, Wwt, Wwt, Wwt, Wwrt, Ds
Wot, Wot, Wot, Wwt, Wwt, Ds, Ds, Ds, Wwrt, Dd^Ftd, Dd^Ftd, Mdd, Ds, Dd^Vda, Ds, Dd^Ftd, Ds, Ds, Wwt, Wwt, Wwt, Wwt, Wwt, Wwt
Wot, Wot, Wwt, Wwt, Wwt, Wwt, Wwt, Wwrt, Wwt, Ds, Wwrt, Ds, Wwt, Wwrt, Wwt, Wwrt, Wwt, Wwt, Ds, Wwt, Wwrt, Ds, Dd^Ftd, Wwrt
Wot, Wwt, Ds, Ds, Dd^Ftd, Wwt, Wwrt, Wwt, Wwt, Wwt, Wwt, Wwt, Ds, Wwt, Wwt, Wwt, Wwt, Wwrt, Wwrt, Wwt, Wwt, Dd^Ftd, Gs^Ft, Dd
