Wot, Wot, Wwt, Wot, Wwt, Wwt, Wwt, Wwt, Wwt, Wot, Wwt, Wot, Wot, Wot, Wot, Wot, Wot, Wot, Wot, Wot, Wot, Wot, Wot, Wot, Wot, Wot, Wot, Wot, Wot, Wot, Wwt, Wot, Wwt, Wot, Wwt, Wot, Wwt, Wot, Wot, Wot, Wot, Wot, Wot, Wot, Wot, Wot
Wot, Wwt, Wwrt, Wwt, Wwrt, Wwrt, Wwrt, Wwt, Ds, Wwrt, Wwrt, Wwt, Wwt, Wot, Wot, Wot, Wot, Wot, Wot, Wot, Wot, Wot, Wot, Wot, Wot, Wot, Wot, Wot, Wwt, Wwt, Ds, Wwt, Wwrt, Wwt, Wwrt, Wwt, Ds, Wwt, Wwt, Wot, Wwt, Wot, Wot, Wot, Wot, Wot
Wot, Wwt, Ds, Dd^Vdt, Dd^Ftd, Mdd, Dd^Ftd, Ds, Gs^Ft, Mdd, Gs^Ftp, Ds, Wwrt, Wwt, Wwt, Wot, Wwt, Wot, Wwt, Wot, Wwt, Wot, Wot, Wot, Wot, Wot, Wwt, Wwt, Wwrt, Wwrt, Dd^Ftd, Dd^Ftd, Dd^Ftd, Ds, Wwrt, Wwrt, Ds, Ds, Wwrt, Wwt, Ds, Wwt, Wwt, Wot, Wot, Wot
Wwt, Wwrt, Gs^Ft, Gs^Ftp, Gll^Ftr, Gs^Ft, Gs^Ft, Gs^Ft, Dd^Ftd, Gs^Ft, Dd^Vdr, Ds, Wwrt, Wwt, Wwt, Wwt, Wwrt, Wwt, Dd^Ftd, Wwt, Wwrt, Wwt, Wwt, Wot, Wot, Wwt, Wwrt, Ds, Dd^Ftd, Dd, Gs^Ftp, Gs^Ft, Gll^Ftr, Mdd, Dd^Ftd, Dd^Ftd, Gs^Ft, Dd^Ftd, Dd^Ftd, Dd^Ftd, Dd^Ftd, Wwrt, Ds, Wwt, Wwt, Wot
Wwt, Ds, Dd^Ftd, Gs^Ftp, Mdd, Gs^Ft, Dd^Ftd, Ds, Wwrt, Ds, Ds, Wwrt, Wwt, Wwrt, Wwt, Wwrt, Ds, Wwrt, Gs^Ftp, Gs^Ftp, Dd^Vdr, Wwrt, Wwt, Wot, Wwt, Wwt, Ds, Dd^Vdr, Gs^Ft, Gs^Ft, Gll^Ftr, Gll^Ftr, Gs^Ft, Gs^Ft, Gll^Ftr, Gs^Ft, Gs^Vc, Gs^Ft, Gll^Ftr, Gs^Ft, Gs^Ft, Dd^Ftd, Dd, Ds, Wwt, Wot
Wot, Wwrt, Ds, Ds, Wwrt, Dd^Vdr, Ds, Ds, Wwrt, Wwrt, Wwt, Wwrt, Wwt, Wwt, Wwt, Wwt, Wwrt, Dd^Ftd, Md, Mv, Md, Dd^Ftd, Wwrt, Wwt, Wwt, Wwrt, Ds, Dd^Ftd, Gs^Ftp, Gll^Ftr, Kdr, Gll^Ftr, Gll^Ftr, Rb, Gg^Efm, Gs^Vc, Gs^Vc, Gg^Ecf, Gll^Ftr, Gll^Ftr, Dd^Ftd, Dd^Ftd, Ds, Wwt, Wot, Wot
Wot, Wwt, Wwt, Wwrt, Wwt, Wwt, Wwrt, Wwt, Wwt, Wwt, Wwt, Ds, Wwrt, Wwt, Wwrt, Wwt, Wwt, Ds, Ds, Md, Gs^Ftp, Gs^Ftp, Wwrt, Wwt, Wwt, Wwt, Wwrt, Dd, Gs^Ftp, Gll^Ftr, Cdr, Cdr, Gs^Ft, Gs^Ft, Gll^Ftr, Gll^Ftr, Gll^Ftr, Gll^Ftr, Mdd, Gll^Ftr, Dd^Ftd, Wwrt, Wwrt, Wwt, Wot, Wot
Wot, Wot, Wot, Wwt, Wwt, Wwt, Wwt, Ds, Wwrt, Wwrt, Ds, Wwrt, Wwt, Ds, Ds, Wwt, Wwt, Wwrt, Wwt, Wwrt, Ds, Dd^Ftd, Wwt, Wwt, Wwt, Ds, Wwt, Ds, Dd^Ftd, Gs^Ftp, Gs^Ft, Gg^Efm, Ds, Gs^Ftp, Gs^Ft, Gs^Ftp, Gs^Ftp, Gll^Ftr, Gs^Ftp, Gll^Ftr, Dd^Ftd, Ds, Wwt, Wwt, Wot, Wot
Wot, Wot, Wot, Wot, Wwt, Wwt, Wwrt, Wwt, Dd^Ftd, Wwrt, Wwrt, Wwt, Wwrt, Wwrt, Wwt, Wwrt, Wwrt, Wwt, Wwt, Wwt, Wwrt, Wwt, Wwrt, Wwt, Wwrt, Wwrt, Wwt, Wwrt, Gs^Ftp, Gs^Ft, Dd^Ftd, Dd^Ftd, Wwrt, Dd^Ftd, Ds, Dd^Ftd, Ds, Dd^Ftd, Dd^Vdr, Dd^Ftd, Wwrt, Ds, Wwt, Wot, Wot, Wot
Wot, Wot, Wwt, Wwt, Wwrt, Ds, Dd^Ftd, Wwrt, Ds, Wwt, Wwrt, Wwt, Wwt, Wwrt, Wwt, Dd^Ftd, Dd^Ftd, Wwrt, Ds, Wwt, Wwt, Wwt, Ds, Dd^Ftd, Wwrt, Wwt, Dd^Vdr, Dd^Ftd, Mdd, Gs^Ftp, Dd^Ftd, Wwrt, Ds, Wwrt, Wwt, Wwrt, Wwt, Wwrt, Wwrt, Ds, Wwt, Wwt, Wot, Wot, Wot, Wot
Wot, Wwt, Ds, Dd^Ftd, Gs^Ft, Mdd, Gs^Ft, Ds, Wwrt, Wwt, Wwt, Wwt, Wwrt, Wwt, Wwt, Wwrt, Mdd, Gs^Ft, Dd^Ftd, Wwrt, Wwt, Wwrt, Wwt, Ds, Wwt, Wwt, Ds, Mdd, Mdd, Mdd, Ds, Wwt, Wwrt, Wwt, Wwt, Wwt, Ds, Wwt, Wwt, Wwt, Wwrt, Wwt, Wot, Wot, Wot, Wot
Wot, Wwt, Ds, Gs^Ft, Gll^Ftr, Gll^Ftr, Gll^Ftr, Gs^Ft, Dd^Vdr, Wwrt, Ds, Wwrt, Wwrt, Ce, Ce, Wwrt, Gll^Ftr, Gs^Ft, Dd^Ftd, Ds, Wwt, Wwt, Wwt, Wwt, Wwt, Wwt, Wwrt, Dd^Ftd, Wwrt, Dd^Ftd, Wwt, Wwrt, Wwt, Wwt, Wwt, Wwt, Wwt, Ds, Wwt, Wwt, Wwt, Wwt, Wot, Wot, Wot, Wot
Wot, Wwt, Wwt, Dd^Ftd, Dd^Vdr, Gs^Ftp, Gll^Ftr, Gll^Ftr, Gll^Ftr, Gs^Ft, Gs^Ft, Dd^Ftd, Gs^Ft, Ket, Gs^Ft, Gs^Ftp, Gs^Ft, Gs^Ft, Ds, Wwt, Wwrt, Wwrt, Wwt, Wwt, Wwrt, Wwt, Wwt, Wwrt, Wwt, Wwt, Wwrt, Wwt, Wwt, Wwrt, Wwt, Wwt, Wwrt, Wwrt, Wwrt, Wwt, Wwt, Wot, Wot, Wot, Wot, Wot
Wot, Wot, Wwt, Ds, Wwrt, Dd^Ftd, Mdd, Gs^Ftp, Dd^Ftd, Gs^Ft, Gs^Ftp, Gs^Ftp, Gs^Ftp, Gll^Ftr, Gs^Ft, Gs^Ftp, Dd^Ftd, Dd^Vdr, Wwrt, Wwt, Wwt, Wwt, Wwrt, Ds, Wwt, Wwt, Wwt, Wwt, Wwrt, Wwt, Wwt, Wwrt, Ds, Ds, Dd^Ftd, Dd^Ftd, Dd^Vdr, Ds, Wwrt, Wwrt, Wwrt, Wwt, Wwt, Wot, Wot, Wot
Wot, Wot, Wot, Wwt, Wwt, Ds, Ds, Ds, Wwrt, Dd^Ftd, Dd^Ftd, Mdd, Ds, Dd^Vdr, Ds, Dd^Ftd, Ds, Ds, Wwt, Wwt, Wwt, Wwt, Wwt, Wwt, Ds, Wwrt, Wwrt, Wwt, Ds, Wwrt, Wwt, Wwt, Wwrt, Dd, Mdd, Gs^Ftp, Mdd, Dd^Ftd, Dd^Ftd, Wwrt, Dd^Ftd, Ds, Wwrt, Wwt, Wot, Wot
Wot, Wot, Wwt, Wwt, Wwt, Wwt, Wwt, Wwrt, Wwt, Ds, Wwrt, Ds, Wwt, Wwrt, Wwt, Wwrt, Wwt, Wwt, Ds, Wwt, Wwrt, Ds, Dd^Ftd, Wwrt, Dd, Dd^Ftd, Dd^Ftd, Dd^Ftd, Gs^Ft, Ds, Wwt, Wwt, Wwt, Ds, Gs^Ftp, Gll^Ftr, Md, Mv, Md, Gs^Ftp, Mdd, Dd, Ds, Wwt, Wot, Wot
Wot, Wwt, Ds, Ds, Dd^Ftd, Wwt, Wwrt, Wwt, Wwt, Wwt, Wwt, Wwt, Ds, Wwt, Wwt, Wwt, Wwt, Wwrt, Wwt, Wwt, Wwt, Dd^Ftd, Gs^Ft, Dd, Gll^Ftr, Gs^Ft, Gll^Ftr, Gll^Ftr, Dd^Ftd, Dd^Ftd, Ds, Wwrt, Wwt, Ds, Dd^Ftd, Gs^Ftp, Gll^Ftr, Md, Gll^Ftr, Gll^Ftr, Gs^Ftp, Dd^Ftd, Wwrt, Wwt, Wot, Wot
Wot, Wwt, Wwrt, Dd^Ftd, Gs^Ft, Dd^Ftd, Dd^Ftd, Ds, Wwrt, Wwt, Ds, Wwrt, Wwt, Wwt, Wwt, Wwt, Wwrt, Wwt, Ds, Wwrt, Ds, Dd^Ftd, Gll^Ftr, Gll^Ftr, Mdd, Mdd, Mdd, Gll^Ftr, Dd^Ftd, Wwrt, Wwrt, Wwt, Wwrt, Wwrt, Ds, Ds, Dd^Ftd, Gs^Ftp, Mdd, Dd^Vdr, Dd^Ftd, Dd^Ftd, Ds, Wwt, Wot, Wot
Wot, Wwt, Ds, Dd^Ftd, Gll^Ftr, Gll^Ftr, Gs^Ft, Dd^Ftd, Dd^Ftd, Wwt, Dd^Ftd, Wwrt, Ds, Wwt, Wwt, Wwt, Wwrt, Ds, Gs^Ft, Ds, Gll^Ftr, Gll^Ftr, Gll^Ftr, Gll^Ftr, Gll^Ftr, Mdd, Gll^Ftr, Gll^Ftr, Gs^Ft, Ds, Ds, Wwt, Ds, Wwt, Wwrt, Wwt, Wwrt, Ds, Ds, Wwrt, Wwt, Ds, Wwt, Wwt, Wot, Wot
Wot, Wwt, Ds, Gs^Ft, Gll^Ftr, Cdr, Gll^Ftr, Gll^Ftr, Gll^Ftr, Gs^Ft, Dd^Ftd, Ds, Ds, Wwrt, Wwt, Wwt, Wwt, Ds, Ds, Gll^Ftr, Cdr, Cdr, Gll^Ftr, Gs^Vc, Gs^Vc, Gll^Ftr, Gll^Ftr, Cdr, Gll^Ftr, Gs^Ft, Dd, Wwrt, Wwrt, Wwt, Wwt, Wwt, Wwt, Wwt, Wwrt, Wwt, Wwt, Wwt, Wot, Wot, Wot, Wot
Wot, Wwt, Wwrt, Dd^Ftd, Gs^Ft, Gll^Ftr, Gs^Vc, Gs^Vc, Gll^Ftr, Gs^Ft, Dd^Ftd, Wwrt, Wwt, Wwrt, Wwt, Wwt, Ds, Wwrt, Dd, Gll^Ftr, Gll^Ftr, Gll^Ftr, Gll^Ftr, Gs^Ecf, Gs^Ft, Gll^Ftr, Gll^Ftr, Gll^Ftr, Gll^Ftr, Mdd, Mdd, Dd, Dd^Ftd, Dd^Ftd, Dd^Ftd, Ds, Wwt, Wwt, Wwt, Wwrt, Wwt, Wot, Wot, Wot, Wot, Wot
Wot, Wwt, Wwrt, Dd, Gs^Ft, Gll^Ftr, Mdd, Gll^Ecf, Gll^Ftr, Gs^Ft, Dd^Ftd, Dd^Ftd, Wwrt, Wwt, Wwt, Wwt, Ds, Dd^Ftd, Gs^Ft, Gll^Ftr, Md, Mv, Md, Gll^Ftr, Gg^Efm, Gs^Ft, Gg^Efm, Gs^Ft, Gg^Efm, Gll^Ftr, Gll^Ftr, Mdd, Gll^Ftr, Gs^Ft, Dd^Ftd, Wwrt, Wwrt, Wwt, Wwt, Wwt, Ds, Wwt, Wot, Wot, Wot, Wot
Wot, Wwt, Ds, Dd^Ftd, Gll^Ftr, Gg^Efm, Gll^Ftr, Mdd, Mdd, Gg^Efm, Gs^Ft, Dd^Ftd, Dd^Vdr, Ds, Wwt, Wwt, Wwrt, Dd^Ftd, Dd^Ftd, Gll^Ftr, Gll^Ftr, Md, Gll^Ftr, Gs^Ft, Gs^Ft, Gg^Efm, Gs^Ft, Gg^Efm, Gg^Efm, Gll^Ftr, Gll^Ftr, Gll^Ftr, Gs^Vc, Gll^Ftr, Gll^Ftr, Dd^Ftd, Dd^Ftd, Ds, Wwrt, Wwrt, Dd^Vdr, Wwt, Wwt, Wot, Wot, Wot
Wot, Wwt, Wwt, Dd^Ftd, Gs^Ft, Gg^Efm, Gll^Ftr, Gll^Ftr, Gs^Ft, Gll^Ftr, Gs^Ft, Dd^Ftd, Ds, Wwrt, Wwt, Ds, Wwt, Wwt, Dd^Vdr, Gs^Ft, Gs^Ft, Gll^Ftr, Gs^Ft, Gll^Ftr, Gs^Ft, Gll^Ftr, Gs^Vc, Gll^Ftr, Gs^Ft, Gs^Ft, Gll^Ftr, Gs^Vc, Gll^Ecf, Gs^Vc, Gll^Ftr, Gs^Ft, Gg^Efm, Ds, Dd^Ftd, Dd^Ftd, Gs^Ft, Dd^Ftd, Ds, Wwt, Wot, Wot
Wot, Wot, Wwt, Ds, Dd^Ftd, Gll^Ftr, Gs^Vc, Gll^Ftr, Gll^Ftr, Gll^Ftr, Gs^Ft, Dd^Ftd, Wwrt, Wwrt, Wwt, Wwt, Wwt, Wwrt, Wwt, Dd^Ftd, Dd^Ftd, Dd^Ftd, Dd, Gll^Ftr, Gll^Ftr, Gs^Vc, Gll^Ecf, Gll^Ftr, Gs^Ft, Gll^Ftr, Gs^Ft, Gll^Ftr, Gll^Ftr, Gll^Ftr, Gll^Ftr, Gll^Ftr, Cdr, Gll^Ftr, Gll^Ftr, Gs^Ft, Gll^Ftr, Dd^Ftd, Wwt, Wwt, Wot, Wot
Wot, Wot, Wwt, Wwrt, Dd^Ftd, Gll^Ftr, Gs^Vc, Gll^Ecf, Gll^Ftr, Gg^Efm, Gs^Ft, Dd^Ftd, Dd^Ftd, Ds, Wwrt, Wwt, Wwt, Wwt, Wwt, Ds, Ds, Wwrt, Wwrt, Dd^Ftd, Gs^Ft, Gll^Ftr, Gll^Ftr, Gs^Ft, Gg^Efm, Gg^Efm, Gg^Efm, Gg^Efm, Gll^Ftr, Cdr, Cdr, Gg^Efm, Cdr, Gll^Ftr, Cdr, Gll^Ftr, Dd^Ftd, Dd^Vdt, Dd^Ftd, Wwt, Wwt, Wot
Wot, Wwt, Ds, Ds, Gs^Ft, Gll^Ftr, Mdd, Mdd, Mdd, Gg^Efm, Gg^Efm, Gs^Ft, Gs^Ft, Dd^Ftd, Ds, Wwrt, Ds, Wwrt, Wwt, Wwrt, Wwt, Wwt, Ds, Dd^Ftd, Gs^Ft, Gll^Ftr, Gs^Ft, Gll^Ftr, Gll^Ftr, Gg^Efm, Gs^Ft, Gll^Ftr, Gs^Ft, Kdr, Gll^Ftr, Gll^Ftr, Gll^Ftr, Kdr, Gll^Ftr, Gll^Ftr, Gs^Ft, Dd, Dd^Ftd, Ds, Wwt, Wot
Wot, Wwt, Wwt, Ds, Dd^Ftd, Gs^Ft, Gll^Ftr, Mdd, Gll^Ftr, Gll^Ftr, Cdr, Gll^Ftr, Cdr, Gg^Efm, Gs^Ft, Dd^Ftd, Wwrt, Wwt, Wwt, Wwt, Wwt, Wwt, Ds, Gs^Ft, Ds, Dd^Ftd, Dd^Ftd, Dd^Ftd, Dd^Ftd, Gll^Ftr, Gs^Ft, Gll^Ftr, Gg^Efm, Gg^Efm, Mdd, Mdd, Mdd, Gll^Ftr, Gll^Ftr, Gs^Ft, Dd, Dd, Ds, Dd^Ftd, Wwt, Wot
Wot, Wot, Wwt, Wwrt, Ds, Gs^Ft, Gs^Ft, Gll^Ftr, Gs^Ft, Gll^Ftr, Gll^Ftr, Gll^Ftr, Kdr, Gll^Ftr, Gs^Ft, Dd^Ftd, Ds, Wwt, Wwt, Wwrt, Ds, Wwrt, Wwt, Ds, Wwt, Wwrt, Ds, Wwrt, Dd^Ftd, Gs^Ft, Dd^Vdr, Gll^Ftr, Gg^Efm, Gll^Ftr, Gll^Ftr, Mdd, Gll^Ftr, Gll^Ftr, Gs^Ft, Dd^Ftd, Dd, Dd^Ftd, Ds, Wwt, Wwt, Wot
Wot, Wot, Wot, Wwt, Wwrt, Dd^Ftd, Dd^Ftd, Dd^Ftd, Dd, Gs^Ft, Gg^Efm, Cdr, Gll^Ftr, Gll^Ftr, Gs^Ft, Dd^Ftd, Ds, Wwrt, Ds, Wwt, Wwrt, Ds, Wwt, Wwt, Wwrt, Wwt, Wwt, Wwrt, Ds, Dd^Ftd, Wwrt, Ds, Dd^Ftd, Gs^Ft, Gs^Ft, Gll^Ftr, Gs^Ft, Gs^Ft, Dd^Ftd, Dd, Dd, Dd^Ftd, Ds, Ds, Wwt, Wot
Wot, Wot, Wot, Wwt, Wwt, Ds, Ds, Wwrt, Wwrt, Dd^Vdr, Gs^Ft, Gll^Ftr, Gs^Ft, Gs^Ft, Dd^Ftd, Dd^Ftd, Dd, Dd^Ftd, Wwrt, Wwt, Wwt, Wwt, Wwt, Wwrt, Wwt, Wwt, Wwrt, Wwt, Wwt, Wwt, Wwt, Wwt, Wwrt, Dd^Ftd, Dd^Ftd, Dd^Ftd, Dd^Vdt, Dd^Ftd, Ds, Dd, Dd^Ftd, Ds, Wwt, Ds, Wwt, Wot
Wot, Wot, Wot, Wot, Wot, Wwt, Wwt, Wwt, Wwt, Ds, Ds, Gs^Ft, Dd^Ftd, Dd^Ftd, Ds, Dd, Dd^Vdt, Dd, Dd, Ds, Wwrt, Wwt, Wwt, Wwt, Wot, Wwt, Wot, Wwt, Wot, Wot, Wwt, Wwrt, Wwt, Ds, Ds, Ds, Wwrt, Ds, Dd^Ftd, Ds, Ds, Ds, Ds, Wwt, Wot, Wot
Wot, Wot, Wot, Wot, Wot, Wot, Wot, Wot, Wot, Wwt, Wwt, Ds, Wwrt, Ds, Wwrt, Dd^Ftd, Ds, Dd^Ftd, Ds, Dd^Ftd, Ds, Ds, Wwt, Wot, Wot, Wot, Wot, Wot, Wot, Wot, Wot, Wwt, Wot, Wwt, Wwt, Wwt, Wwt, Ds, Wwt, Wwt, Wwt, Ds, Ds, Wwt, Wot, Wot
Wot, Wot, Wot, Wot, Wot, Wot, Wot, Wot, Wot, Wot, Wot, Wwt, Wot, Wwt, Wot, Wwt, Wwt, Wwrt, Wwt, Wwrt, Wwt, Wwrt, Wot, Wot, Wot, Wot, Wot, Wot, Wot, Wot, Wot, Wot, Wot, Wot, Wot, Wot, Wwt, Ds, Wwt, Wot, Wot, Wwt, Wwt, Wwt, Wot, Wot
Wot, Wot, Wot, Wot, Wot, Wot, Wot, Wot, Wot, Wot, Wot, Wot, Wot, Wot, Wot, Wot, Wot, Wot, Wot, Wot, Wot, Wot, Wot, Wot, Wot, Wot, Wot, Wot, Wot, Wot, Wot, Wot, Wot, Wot, Wot, Wot, Wot, Wwt, Wot, Wot, Wot, Wot, Wot, Wot, Wot, Wot
