Wot, Wot, Wot, Wot, Wot, Wot, Wot, Wot, Wot, Wot, Wot, Wot, Wot, Wot, Wot, Wot, Wot, Wot, Wot, Wot, Wot, Wot, Wot, Wot, Wot, Wot, Wwt, Wwt, Wwt, Wot, Wwt, Wwt, Ds, Wwt, Wwt, Wot, Wwt, Wwt, Wwt, Wot, Wot, Wot, Wot, Wot, Wot, Wot, Wot, Wot, Wot, Wot, Wot, Wot
Wot, Wot, Wot, Wot, Wot, Wot, Wwt, Wot, Wwt, Wot, Wwt, Wot, Wot, Wot, Wot, Wot, Wot, Wot, Wot, Wot, Wot, Wot, Wot, Wot, Wwt, Wwt, Wwt, Wwrt, Wwrt, Wwt, Wwrt, Ds, Dd^Ftd, Ds, Ds, Wwt, Ds, Wwrt, Wwt, Wwt, Wwt, Wot, Wwt, Wwt, Wwt, Wot, Wot, Wot, Wot, Wot, Wot, Wot
Wot, Wot, Wot, Wot, Wwt, Wwt, Wwrt, Wwt, Wwrt, Wwt, Ds, Wwt, Wwt, Wot, Wot, Wot, Wot, Wot, Wot, Wot, Wot, Wot, Wot, Wwt, Wwrt, Wwrt, Dd^Ftd, Wwrt, Dd^Ftd, Ds, Dd^Ftd, Dd^Ftd, Gs^Ft, Dd^Ftd, Ds, Wwrt, Wwrt, Wwrt, Ds, Wwrt, Wwt, Wwt, Wwt, Wwrt, Wwt, Wot, Wot, Wot, Wot, Wot, Wot, Wot
Wot, Wot, Wot, Wwt, Ds, Ds, Dd^Ftd, Ds, Ds, Dd^Ftd, Gs^Ft, Dd^Ftd, Ds, Wwt, Wwt, Wot, Wot, Wot, Wot, Wot, Wot, Wot, Wwt, Wwt, Wwrt, Dd^Ftd, Gs^Ft, Dd^Ftd, Gs^Ft, Gs^Ft, Gs^Ft, Gs^Ft, Gs^Ftp, Gs^Ftp, Gs^Ft, Ds, Wwt, Wwt, Wwt, Ds, Wwrt, Wwrt, Ds, Ds, Wwt, Wot, Wwt, Wot, Wot, Wot, Wot, Wot
Wot, Wot, Wot, Wwt, Ds, Gs^Ft, Gs^Ftp, Gll^Ftr, Cdr, Gll^Ftr, Cdr, Gs^Ft, Dd^Ftd, Wwrt, Wwt, Wot, Wot, Wot, Wwt, Wot, Wot, Wwt, Wwrt, Wwt, Dd^Ftd, Ds, Cdr, Gll^Ftr, Gll^Ftr, Gll^Ftr, Gll^Ftr, Gll^Ftr, Gll^Ftr, Gll^Ftr, Gll^Ftr, Ds, Ds, Wwrt, Wwrt, Wwrt, Wwt, Wwt, Wwrt, Wwt, Ds, Wwt, Ds, Wwt, Wot, Wot, Wot, Wot
Wot, Wot, Wot, Wwt, Wwrt, Dd^Ftd, Gs^Ft, Gll^Ftr, Gll^Ftr, Kdr, Cdr, Gll^Ftr, Gs^Ftp, Ds, Ds, Wwt, Wwt, Wwt, Wwt, Wwt, Wwt, Wwt, Wwt, Wwt, Dd^Ftd, Gs^Ft, Kdr, Cdr, Gll^Ftr, Gll^Ftr, Mv, Gll^Ftr, Gs^Ftp, Kdr, Gll^Ftr, Gll^Ftr, Gll^Ftr, Dd^Ftd, Dd, Dd^Ftd, Dd, Wwrt, Wwrt, Dd^Ftd, Gs^Ftp, Dd^Ftd, Dd^Ftd, Wwt, Wot, Wot, Wot, Wot
Wot, Wot, Wot, Wwt, Wwt, Ds, Ds, Dd^Ftd, Ds, Gs^Ft, Ds, Dd^Ftd, Ds, Gs^Ft, Ds, Wwrt, Wwt, Wwrt, Ds, Ds, Ds, Wwrt, Wwrt, Wwt, Ds, Cdr, Gs^Ft, Gll^Ftr, Cdr, Md, Md, Md, Gs^Ftp, Rb, Gs^Vc, Gll^Ftr, Gll^Ftr, Gs^Ftp, Gll^Ftr, Gs^Ftp, Gs^Ftp, Dd^Ftd, Dd^Ftd, Dd^Ftd, Dd^Ftd, Dd^Ftd, Wwrt, Wwt, Wwt, Wot, Wot, Wot
Wot, Wot, Wot, Wot, Wot, Wwt, Wwt, Wwrt, Wwt, Ds, Wwt, Wwrt, Wwt, Ds, Wwrt, Wwt, Wwt, Wwrt, Wwrt, Dd^Ftd, Wwrt, Ds, Wwt, Wwt, Wwt, Dd^Ftd, Gs^Ft, Gll^Ftr, Gll^Ftr, Gll^Ftr, Gll^Ftr, Gll^Ftr, Gll^Ftr, Gs^Vc, Gll^Ecf, Gs^Vc, Gll^Ftr, Gs^Ft, Gll^Ftr, Gll^Ftr, Gll^Ftr, Gs^Ft, Gll^Ftr, Gs^Ft, Dd^Ftd, Wwrt, Wwrt, Wwt, Ds, Wwt, Wot, Wot
Wot, Wot, Wot, Wot, Wot, Wot, Wot, Wwt, Wwt, Wwt, Wwrt, Wwt, Wwrt, Wwt, Wwt, Wwrt, Ds, Wwt, Wwt, Wwt, Wwt, Wwt, Wwt, Wwrt, Wwt, Ds, Dd^Ftd, Gs^Ftp, Dd^Ftd, Gs^Ft, Dd^Ftd, Gll^Ftr, Gll^Ftr, Gll^Ftr, Gll^Ftr, Gs^Ft, Gg^Efm, Gs^Ft, Gs^Ft, Gs^Ft, Gll^Ftr, Gll^Ftr, Gs^Vc, Gs^Ft, Gs^Ftp, Dd^Ftd, Dd^Ftd, Ds, Ds, Wwt, Wwt, Wot
Wot, Wot, Wot, Wot, Wot, Wot, Wot, Wot, Wwt, Wwrt, Ds, Dd^Ftd, Ds, Wwt, Wwrt, Ds, Dd^Ftd, Wwrt, Wwt, Wwt, Wwt, Wwt, Wwt, Wwrt, Wwt, Wwt, Wwrt, Dd^Ftd, Ds, Dd, Wwrt, Dd^Ftd, Ds, Dd^Ftd, Dd^Ftd, Gs^Ftp, Gs^Ftp, Gg^Efm, Gs^Ft, Rb, Gs^Ft, Gs^Vc, Gg^Ecf, Gll^Ftr, Gll^Ftr, Gs^Ftp, Ds, Ds, Wwrt, Ds, Wwt, Wot
Wot, Wot, Wot, Wot, Wot, Wot, Wot, Wot, Wwt, Ds, Wwrt, Wwrt, Wwt, Wwt, Wwt, Wwrt, Wwt, Ds, Wwt, Wwt, Wwt, Wwt, Wwt, Wwt, Dd^Ftd, Wwt, Wwrt, Wwrt, Wwrt, Wwrt, Wwt, Wwt, Wwrt, Ds, Wwrt, Dd^Ftd, Dd^Ftd, Gll^Ftr, Gs^Ft, Gs^Ft, Gs^Ft, Gll^Ftr, Gll^Ftr, Gs^Vc, Gll^Ftr, Dd^Ftd, Ds, Wwrt, Wwt, Wwt, Wot, Wot
Wot, Wot, Wot, Wot, Wwt, Wot, Wwt, Wwt, Wwrt, Wwt, Wwt, Wwt, Wwrt, Wwrt, Wwrt, Wwrt, Wwt, Wwt, Wwt, Wwt, Wwrt, Wwrt, Wwt, Ds, Wwt, Wwt, Ds, Wwt, Wwt, Wwt, Wwt, Wwt, Wwrt, Wwrt, Wwt, Wwrt, Dd, Gs^Ftp, Gs^Ft, Gll^Ftr, Gs^Ft, Gg^Efm, Gs^Ft, Gll^Ftr, Gll^Ftr, Gs^Ft, Ds, Wwrt, Wwt, Wot, Wot, Wot
Wot, Wot, Wwt, Wwt, Wwrt, Wwt, Wwt, Wwrt, Wwt, Wwrt, Wwt, Wwt, Wwt, Wwt, Wwt, Wwt, Wwt, Wwt, Wwt, Wwt, Wwt, Wwt, Wwrt, Wwt, Wwt, Wwrt, Wwrt, Wwt, Wwt, Wwt, Wwrt, Ds, Wwt, Wwt, Wwt, Wwt, Wwt, Dd^Ftd, Gs^Ftp, Gll^Ftr, Gll^Ftr, Gs^Ft, Cdr, Gll^Ftr, Cdr, Gg^Efm, Gs^Ft, Ds, Wwrt, Wwt, Wwt, Wot
Wot, Wwt, Wwrt, Wwrt, Wwt, Wwt, Wwt, Wwt, Ds, Wwrt, Wwrt, Wwrt, Ds, Dd^Ftd, Ds, Ds, Ds, Wwrt, Wwrt, Wwt, Ds, Ds, Gs^Ft, Ds, Dd^Ftd, Ds, Ds, Wwrt, Ds, Wwt, Wwrt, Wwt, Wwt, Wwt, Dd^Ftd, Wwt, Wwrt, Dd^Ftd, Dd^Ftd, Gs^Ft, Gs^Ft, Gs^Ft, Kdr, Cdr, Cdr, Gll^Ftr, Gll^Ftr, Ds, Ds, Wwrt, Wwt, Wot
Wwt, Wwt, Wwrt, Wwt, Ds, Ds, Dd^Ftd, Ds, Gs^Ft, Ds, Dd^Ftd, Dd^Ftd, Dd^Ftd, Ds, Wwt, Ds, Wwrt, Wwrt, Wwt, Ds, Wwt, Dd^Ftd, Ds, Dd^Ftd, Ds, Gs^Ft, Gs^Ftp, Dd^Ftd, Gs^Ft, Ds, Ds, Wwrt, Wwrt, Ds, Ds, Wwrt, Wwt, Wwrt, Ds, Gs^Ftp, Gll^Ftr, Gll^Ftr, Gll^Ftr, Gll^Ftr, Gg^Efm, Gs^Ftp, Gs^Ft, Gs^Ft, Ds, Wwt, Wot, Wot
Wwrt, Wwt, Wwt, Wwt, Dd^Ftd, Gs^Ft, Gs^Ftp, Gll^Ftr, Kdr, Gll^Ftr, Gs^Ftp, Gs^Ft, Ds, Wwt, Wwt, Wwt, Ds, Wwt, Wwt, Wwt, Wwt, Wwrt, Wwrt, Wwt, Wwt, Dd^Ftd, Gs^Ft, Gll^Ftr, Gg^Efm, Gll^Ftr, Ds, Wwt, Wwt, Wwrt, Wwt, Wwt, Wwt, Wwrt, Ds, Gs^Ftp, Gll^Ftr, Cdr, Gll^Ftr, Gs^Ftp, Dd^Ftd, Ds, Ds, Ds, Wwt, Wwt, Wwt, Wot
Wwrt, Wwt, Wwt, Ds, Gs^Ft, Gll^Ftr, Gll^Ftr, Gll^Ftr, Gll^Ftr, Gll^Ftr, Dd^Ftd, Ds, Wwrt, Wwt, Wwt, Wwrt, Wwt, Wwt, Wwt, Wwt, Wwt, Ds, Dd^Ftd, Wwt, Wwt, Ds, Ds, Gll^Ftr, Gll^Ftr, Cdr, Gll^Ftr, Ds, Wwt, Wwt, Wwt, Wwt, Wwrt, Wwrt, Ds, Gs^Ftp, Dd^Ftd, Gs^Ftp, Gs^Ftp, Dd^Ftd, Wwt, Wwt, Wwt, Wwt, Wwrt, Wwrt, Wwt, Wot
Wwt, Wwt, Ds, Dd^Ftd, Gll^Ftr, Gs^Vc, Gs^Vc, Rb, Gs^Ft, Gs^Ft, Ds, Wwt, Wwt, Ds, Wwt, Wwt, Wwt, Wwt, Wwt, Wwt, Wwt, Wwt, Wwt, Wwt, Wwt, Wwrt, Wwrt, Dd^Ftd, Gs^Ft, Kdr, Gll^Ftr, Dd^Ftd, Ds, Wwrt, Ds, Ds, Wwrt, Wwt, Wwrt, Dd^Ftd, Wwrt, Dd^Ftd, Ds, Dd^Ftd, Wwt, Wwt, Wwt, Wwrt, Wwt, Wwt, Wot, Wot
Wot, Wwt, Dd^Ftd, Gs^Ft, Gs^Ft, Gg^Ecf, Gs^Ft, Gll^Ftr, Dd^Ftd, Ds, Wwt, Wwrt, Ds, Dd^Ftd, Wwt, Wwt, Wwt, Wwt, Wwt, Wwt, Wwt, Wwt, Wwt, Wwt, Wwt, Ds, Wwt, Ds, Ds, Gll^Ftr, Gll^Ftr, Gs^Ft, Dd^Ftd, Wwrt, Wwrt, Wwt, Wwt, Wwt, Ds, Wwrt, Wwt, Wwrt, Wwt, Wwt, Wwrt, Wwt, Wot, Wwt, Wot, Wot, Wot, Wot
Wot, Ds, Gs^Ft, Gll^Ftr, Gll^Ftr, Gs^Vc, Gll^Ftr, Gs^Ft, Ds, Wwt, Wwt, Wwt, Wwt, Wwt, Wwt, Wwt, Wwt, Wwt, Wwt, Wwt, Wwt, Wwt, Wwt, Wwt, Wwt, Wwt, Wwt, Wwt, Wwrt, Dd^Ftd, Gs^Ft, Gg^Efm, Gs^Ft, Ds, Wwrt, Wwt, Wwrt, Dd^Ftd, Ds, Wwt, Wwrt, Wwt, Wwt, Wwt, Wwt, Wwt, Wwt, Wot, Wot, Wot, Wot, Wot
Ds, Dd^Ftd, Gll^Ftr, Gll^Ftr, Cdr, Gll^Ftr, Dd^Ftd, Ds, Wwrt, Wwt, Wwrt, Wwt, Wwt, Wwt, Wwt, Wwt, Wwt, Wwrt, Wwt, Wwt, Wwrt, Wwt, Wwt, Wwt, Wwt, Wwt, Ds, Wwt, Wwrt, Ds, Dd^Ftd, Gs^Ftp, Dd^Ftd, Ds, Wwrt, Ds, Ds, Wwrt, Wwt, Wwrt, Ds, Wwt, Wwrt, Wwt, Wwt, Wwrt, Wwt, Wwt, Wwt, Wot, Wot, Wot
Gll^Ftr, Gs^Ft, Gll^Ftr, Cdr, Gs^Ft, Gg^Efm, Ds, Wwrt, Wwt, Ds, Wwt, Wwt, Wwt, Wwt, Wwrt, Wwt, Wwrt, Wwt, Ds, Wwt, Wwt, Wwrt, Wwt, Wwt, Wwt, Wwt, Wwt, Dd^Ftd, Wwt, Wwt, Ds, Gs^Ft, Ds, Wwt, Wwt, Wwt, Wwt, Wwt, Wwt, Ds, Dd^Ftd, Dd^Ftd, Dd^Ftd, Wwrt, Ds, Wwt, Dd^Ftd, Wwrt, Wwt, Wot, Wot, Wot
Gll^Ftr, Gs^Ft, Cdr, Kdr, Gll^Ftr, Gs^Ft, Ds, Wwt, Wwt, Wwt, Wwt, Wwt, Wwt, Wwt, Wwt, Wwt, Dd^Ftd, Wwrt, Mdd, Dd^Ftd, Wwrt, Wwt, Wwt, Wwt, Wwt, Wwt, Wwt, Ds, Wwt, Wwt, Wwt, Ds, Wwrt, Wwt, Wwt, Wwt, Wwrt, Wwt, Wwt, Ds, Dd^Ftd, Gs^Ftp, Gs^Ftp, Dd^Ftd, Gs^Ftp, Mdd, Dd^Ftd, Dd, Ds, Wot, Wot, Wot
Gll^Ftr, Gs^Ft, Gll^Ftr, Cdr, Gll^Ftr, Gs^Ft, Ds, Wwrt, Dd^Ftd, Ds, Wwt, Wwt, Wwt, Wwt, Wwt, Wwrt, Ds, Mdd, Mdd, Mdd, Ds, Wwrt, Wwt, Wwt, Wwt, Wwt, Wwt, Wwt, Wwt, Wwt, Wwt, Wwrt, Wwt, Wwt, Wwt, Wwt, Dd^Ftd, Wwt, Wwt, Wwt, Wwrt, Dd^Ftd, Dd^Ftd, Gll^Ftr, Cdr, Gs^Ftp, Ds, Wwrt, Wwrt, Wwt, Wot, Wot
Gll^Ftr, Gs^Ftp, Gll^Ftr, Gg^Efm, Gg^Efm, Gg^Efm, Dd^Ftd, Wwrt, Wwrt, Ds, Wwt, Wwt, Wwt, Wwt, Wwt, Wwt, Wwrt, Dd^Ftd, Wwrt, Dd^Ftd, Wwt, Wwt, Wwrt, Wwt, Wwt, Wwt, Wwt, Wwt, Wwt, Wwt, Ds, Wwrt, Ds, Wwt, Wwt, Wwrt, Ds, Wwrt, Wwt, Wwt, Wwrt, Ds, Gs^Ftp, Gll^Ftr, Kdr, Cdr, Dd^Ftd, Ds, Wwrt, Wwt, Wot, Wot
Ds, Gs^Ft, Gll^Ftr, Gs^Ft, Gg^Efm, Gs^Ft, Gs^Ft, Ds, Wwt, Wwt, Wwt, Wwt, Wwt, Wwt, Wwt, Wwrt, Wwt, Wwt, Wwt, Wwt, Wwrt, Wwt, Wwt, Wwt, Wwt, Wwt, Wwt, Wwt, Wwrt, Wwt, Dd^Ftd, Dd^Ftd, Dd^Ftd, Wwt, Wwt, Wwt, Wwrt, Wwrt, Wwt, Wwt, Ds, Dd^Ftd, Mdd, Gll^Ftr, Gll^Ftr, Gs^Ftp, Dd^Ftd, Wwrt, Wwt, Wwt, Wot, Wot
Wwt, Dd^Ftd, Gs^Ft, Gs^Ft, Gs^Ft, Gs^Ft, Gll^Ftr, Ds, Ds, Wwt, Wwt, Ds, Wwt, Wwt, Wwt, Wwt, Wwt, Wwrt, Wwt, Wwt, Wwt, Wwt, Wwt, Wwt, Wwt, Wwt, Ds, Dd^Ftd, Wwrt, Ds, Gs^Ft, Gs^Ftp, Gs^Ft, Ds, Wwt, Wwt, Wwt, Wwt, Wwt, Wwt, Ds, Gs^Ftp, Dd^Ftd, Gs^Ftp, Dd^Ftd, Dd^Ftd, Ds, Ds, Wwt, Wot, Wot, Wot
Wwt, Ds, Dd^Ftd, Gs^Ftp, Gll^Ftr, Gg^Efm, Gs^Ft, Gs^Ft, Dd^Ftd, Wwrt, Wwrt, Dd^Ftd, Wwrt, Wwt, Wwt, Wwt, Wwt, Wwt, Wwt, Wwt, Wwt, Wwt, Wwt, Wwt, Wwt, Wwt, Wwt, Wwrt, Ds, Dd^Ftd, Gll^Ftr, Gll^Ftr, Gs^Ft, Dd^Ftd, Wwrt, Wwt, Wwt, Wwt, Wwt, Wwrt, Wwrt, Ds, Wwrt, Dd^Ftd, Ds, Wwt, Wwrt, Wwrt, Wwt, Wot, Wot, Wot
Wwt, Wwt, Ds, Gs^Ft, Gll^Ftr, Kdr, Gg^Efm, Gs^Ft, Gll^Ftr, Ds, Ds, Wwrt, Wwt, Wwt, Wwt, Wwt, Wwt, Wwt, Wwt, Wwt, Wwt, Wwt, Wwt, Wwt, Ds, Wwt, Wwt, Ds, Gll^Ftr, Gll^Ftr, Cdr, Gll^Ftr, Dd^Ftd, Ds, Wwrt, Wwt, Ds, Wwt, Wwrt, Wwt, Wwt, Wwt, Wwt, Wwt, Wwt, Wwt, Wwt, Wwt, Wot, Wot, Wot, Wot
Wot, Wwt, Wwrt, Dd^Ftd, Gs^Ft, Gll^Ftr, Gs^Ft, Gll^Ftr, Gs^Vc, Gll^Ftr, Gs^Ft, Ds, Wwrt, Ds, Ds, Wwt, Wwt, Wwt, Wwt, Wwt, Wwt, Ds, Dd^Ftd, Wwt, Wwrt, Wwrt, Ds, Dd^Ftd, Gll^Ecf, Gs^Vc, Gll^Ftr, Gs^Ft, Ds, Wwrt, Wwt, Ds, Wwt, Wwrt, Ds, Wwt, Wwt, Wwt, Wot, Wot, Wot, Wot, Wot, Wot, Wot, Wot, Wot, Wot
Wot, Wwt, Wwt, Ds, Ds, Gs^Ftp, Gll^Ftr, Gs^Vc, Gll^Ecf, Gll^Ftr, Gll^Ftr, Dd^Ftd, Ds, Wwrt, Wwrt, Wwt, Wwt, Wwt, Wwt, Wwt, Wwt, Wwt, Wwrt, Wwt, Wwt, Ds, Gs^Ft, Gs^Ftp, Gs^Vc, Gll^Ftr, Dd^Ftd, Ds, Wwt, Wwt, Wwt, Wwt, Wwt, Ds, Dd^Ftd, Wwrt, Wwt, Wwt, Wot, Wot, Wot, Wot, Wot, Wot, Wot, Wot, Wot, Wot
Wot, Wot, Wwt, Wwt, Wwt, Dd^Ftd, Gs^Ft, Gll^Ftr, Gll^Ftr, Gs^Vc, Gll^Ftr, Gs^Ftp, Gs^Ftp, Ds, Dd^Ftd, Ds, Ds, Wwt, Wwt, Wwt, Ds, Ds, Ds, Ds, Dd^Ftd, Ds, Gll^Ftr, Gll^Ftr, Gs^Ftp, Gll^Ftr, Ds, Wwrt, Wwt, Wwt, Wwt, Wwt, Ds, Dd^Ftd, Dd^Ftd, Ds, Wwrt, Wwt, Wwt, Wot, Wot, Wot, Wot, Wot, Wot, Wot, Wot, Wot
Wot, Wot, Wwt, Wwrt, Wwt, Ds, Ds, Gs^Ft, Dd^Ftd, Gll^Ftr, Gs^Ft, Gll^Ftr, Gs^Ftp, Gs^Ftp, Gs^Ftp, Gs^Ft, Ds, Wwt, Wwt, Wwt, Ds, Dd^Ftd, Gll^Ftr, Gs^Ft, Gs^Ft, Gll^Ftr, Dd^Ftd, Dd^Ftd, Ds, Ds, Wwt, Wwrt, Ds, Dd^Ftd, Wwt, Wwt, Wwt, Ds, Wwt, Wwt, Wwrt, Wwt, Wwrt, Wwt, Wwt, Wwt, Wwt, Wwt, Wwt, Wot, Wot, Wot
Wwt, Wwt, Wwt, Wwrt, Wwt, Wwt, Wwt, Ds, Wwrt, Ds, Ds, Dd^Ftd, Ds, Gs^Ft, Ds, Ds, Wwrt, Wwrt, Wwrt, Wwrt, Ds, Gs^Ftp, Ds, Dd^Ftd, Ds, Ds, Wwrt, Wwrt, Wwrt, Wwt, Wwt, Wwt, Wwt, Wwt, Wwt, Wwt, Wwt, Wwrt, Wwrt, Wwrt, Wwt, Wwt, Wwt, Wwt, Wwt, Wwrt, Wwrt, Wwrt, Wwt, Wot, Wwt, Wot
Wwt, Wwrt, Ds, Wwt, Ds, Wwt, Wwt, Wwt, Dd^Ftd, Wwrt, Wwt, Wwt, Wwt, Ds, Wwt, Wwt, Wwt, Wwt, Wwt, Wwrt, Wwt, Ds, Wwrt, Wwrt, Wwt, Wwt, Ds, Wwt, Ds, Wwt, Wwt, Wwt, Wwt, Ds, Ds, Wwt, Wwt, Wwt, Ds, Wwt, Ds, Ds, Dd^Ftd, Ds, Dd^Ftd, Wwt, Wwt, Wwt, Wwt, Wwt, Ds, Wwrt
Dd^Ftd, Dd^Ftd, Gs^Ft, Dd^Ftd, Gs^Ft, Ds, Ds, Wwrt, Ds, Wwt, Wwt, Wwt, Wwt, Wwt, Wwt, Wwt, Wot, Wwt, Wot, Wwt, Wwt, Wwt, Wwt, Ds, Wwt, Wwrt, Wwt, Dd^Ftd, Wwrt, Wwt, Wwt, Wwt, Wwt, Wwt, Wwt, Wwt, Ds, Ds, Gs^Ft, Dd^Ftd, Gg^Efm, Gs^Ft, Gll^Ftr, Gs^Ft, Gs^Ft, Dd^Ftd, Ds, Ds, Dd^Ftd, Ds, Gs^Ftp, Dd^Ftd
Gll^Ftr, Gs^Ftp, Gll^Ftr, Gll^Ftr, Gll^Ftr, Gs^Ft, Dd^Ftd, Wwrt, Wwrt, Wwt, Wwt, Wwt, Wot, Wot, Wot, Wot, Wot, Wot, Wot, Wot, Wot, Wwt, Wwt, Ds, Wwrt, Wwt, Wwt, Wwrt, Ds, Wwt, Ds, Ds, Ds, Wwt, Ds, Wwt, Dd^Ftd, Gs^Ft, Gll^Ftr, Gll^Ftr, Cdr, Gll^Ftr, Cdr, Gll^Ftr, Gll^Ftr, Gg^Efm, Gs^Ft, Gs^Ft, Gll^Ftr, Gs^Ftp, Gll^Ftr, Gll^Ftr
Gll^Ftr, Gll^Ftr, Gs^Vc, Gs^Vc, Gll^Ftr, Gll^Ftr, Gg^Efm, Ds, Wwrt, Ds, Wwt, Wwt, Wwt, Wot, Wot, Wot, Wot, Wot, Wot, Wot, Wot, Wwt, Wwt, Wwrt, Ds, Ds, Dd^Ftd, Ds, Gs^Ft, Dd^Ftd, Gs^Ftp, Gs^Ft, Gs^Ftp, Dd^Ftd, Gs^Ft, Dd^Ftd, Gll^Ftr, Gll^Ftr, Gll^Ftr, Gll^Ftr, Gll^Ftr, Gg^Efm, Cdr, Gll^Ftr, Cdr, Gg^Efm, Gg^Efm, Gs^Ft, Gs^Vc, Gll^Ftr, Gll^Ftr, Gll^Ftr
Gll^Ftr, Gll^Ftr, Gs^Vc, Gg^Ecf, Gs^Ft, Gg^Efm, Gs^Ft, Dd^Ftd, Dd^Ftd, Wwt, Wwt, Wwt, Wwt, Wot, Wot, Wot, Wot, Wot, Wot, Wot, Wwt, Wwt, Wwt, Wwt, Ds, Gs^Ft, Gll^Ftr, Gs^Ftp, Gll^Ftr, Gll^Ftr, Gll^Ftr, Ss^Ftm, Gs^Ft, Gll^Ftr, Gll^Ftr, Gll^Ftr, Gll^Ftr, Ss^Ftm, Gs^Ft, Cdr, Gll^Ftr, Gg^Efm, Kdr, Kdr, Gg^Efm, Gll^Ftr, Gs^Ft, Gs^Ft, Gg^Ecf, Gs^Vc, Gs^Ft, Gs^Ft
Gs^Ft, Gll^Ftr, Gll^Ftr, Gll^Ftr, Gg^Efm, Gg^Efm, Gll^Ftr, Gll^Ftr, Ds, Ds, Ds, Wwt, Wwt, Wwt, Wwt, Wot, Wwt, Wot, Wwt, Wwt, Wwt, Wwt, Wwt, Ds, Gs^Ft, Gg^Efm, Cdr, Gll^Ftr, Gll^Ftr, Gs^Ft, Gg^Efm, Gs^Ft, Gg^Efm, Gg^Efm, Gs^Ft, Gll^Ftr, Gs^Vc, Gs^Ft, Gg^Efm, Cdr, Gll^Ftr, Cdr, Gll^Ftr, Cdr, Gs^Ft, Cdr, Ss, Gll^Ftr, Ss^Ftm, Ss, Gs^Ft, Ds
Gs^Ft, Gg^Efm, Gll^Ftr, Gs^Ft, Gll^Ftr, Cdr, Kdr, Cdr, Gll^Ftr, Gs^Ft, Dd^Ftd, Wwt, Wwt, Wwt, Wwt, Wwt, Wwt, Wwt, Wwt, Wwt, Wwt, Wwt, Dd^Ftd, Ds, Gg^Efm, Gll^Ftr, Kdr, Cdr, Gll^Ftr, Gs^Ft, Gll^Ftr, Gg^Efm, Gs^Ft, Gg^Efm, Gll^Ftr, Gs^Vc, Gg^Ecf, Gll^Ftr, Gs^Ft, Gs^Ft, Kdr, Gll^Ftr, Cdr, Gg^Efm, Gs^Ft, Gll^Ftr, Gll^Ftr, Ss, Ss, Ss, Ss, Wwrt
Gll^Ftr, Gs^Ft, Gs^Vc, Rb, Gll^Ftr, Gll^Ftr, Gll^Ftr, Cdr, Gll^Ftr, Gll^Ftr, Gs^Ftp, Dd^Ftd, Ds, Wwt, Ds, Wwt, Wwt, Wwt, Wwt, Wwt, Ds, Ds, Gs^Ft, Gll^Ftr, Cdr, Cdr, Gll^Ftr, Gs^Ft, Rb, Gs^Vc, Gs^Vc, Gll^Ftr, Gll^Ftr, Gll^Ftr, Gll^Ftr, Gll^Ftr, Gll^Ftr, Gs^Vc, Gll^Ftr, Gll^Ftr, Gll^Ftr, Gll^Ftr, Gll^Ftr, Gs^Ft, Gll^Ecf, Gs^Vc, Gll^Ftr, Gs^Ft, Gg^Efm, Ss^Ftm, Wwrt, Wwt
Gll^Ftr, Gll^Ftr, Gll^Ftr, Gg^Ecf, Gll^Ftr, Cdr, Gll^Ftr, Gll^Ftr, Gll^Ftr, Ss^Ftm, Ss^Ftm, Gs^Ftp, Gll^Ftr, Dd^Ftd, Gs^Ft, Ds, Dd^Ftd, Ds, Dd^Ftd, Dd^Ftd, Gs^Ftp, Gs^Ft, Gll^Ftr, Gll^Ftr, Gll^Ftr, Gll^Ftr, Gll^Ftr, Gll^Ftr, Gs^Ft, Gg^Ecf, Gll^Ftr, Gll^Ftr, Ss^Ftm, Ss^Ftm, Ss^Ftm, Ss^Ftm, Gll^Ftr, Gll^Ftr, Ss^Ftm, Ss^Ftm, Ss^Ftm, Ss^Ftm, Gll^Ftr, Gll^Ftr, Gs^Vc, Gs^Vc, Gll^Ftr, Gs^Ft, Gs^Ft, Ss^Ftm, Wwt, Wwt
Gll^Ftr, Ss^Ftm, Gll^Ftr, Gll^Ftr, Gll^Ftr, Ss^Ftm, Gll^Ftr, Gll^Ftr, Gll^Ftr, Gll^Ftr, Gll^Ftr, Gll^Ftr, Gll^Ftr, Gll^Ftr, Gll^Ftr, Gll^Ftr, Gll^Ftr, Gs^Ft, Gll^Ftr, Gll^Ftr, Gll^Ftr, Gll^Ftr, Gll^Ftr, Gll^Ftr, Gll^Ftr, Gll^Ftr, Gll^Ftr, Gll^Ftr, Gll^Ftr, Gs^Ft, Gll^Ftr, Gll^Ftr, Gll^Ftr, Gll^Ftr, Gll^Ftr, Gll^Ftr, Gll^Ftr, Gll^Ftr, Gll^Ftr, Gll^Ftr, Gll^Ftr, Gll^Ftr, Gll^Ftr, Gll^Ftr, Gll^Ftr, Gll^Ftr, Gll^Ftr, Ss^Ftm, Gs^Ft, Gs^Ft, Gll^Ftr, Wwt
