Ds, Dd^Ftd, Gll^Ftr, Gs^Ft, Gs^Ft, Gll^Ftr, Dd^Ftd, Dd^Ftd, Ds, Ds, Wwt, Wwrt, Ds, Dd^Ftd, Wwt, Wwt, Wwt, Ds, Wwt, Wwt, Wwrt, Wwt, Wwrt, Wwt, Wwt, Wwt, Wwt, Wwt, Wwt, Wot, Wot, Wot, Wot, Wot, Wot, Wot, Wot, Wot, Wot, Wot, Wot, Wot, Wwt, Wwt, Ds, Ds, Gll^Ftr, Gll^Ftr, Gll^Ftr, Gll^Ftr
Ds, Gs^Ftp, Ds, Dd^Ftd, Ds, Ds, Wwrt, Wwrt, Wwrt, Wwt, Wwt, Wwt, Wwt, Wwt, Wwt, Wwt, Wwt, Wwrt, Wwrt, Wwrt, Wwt, Wwt, Wwt, Wwt, Wwt, Wwrt, Wwrt, Wwrt, Wwt, Wot, Wwt, Wwt, Wwt, Wwt, Wwt, Wot, Wwt, Wwt, Wwt, Wwt, Wwt, Wwt, Wwrt, Ds, Gll^Ftr, Gll^Ftr, Gll^Ftr, Gll^Ftr, Gll^Ftr, Gll^Ftr
Wwt, Ds, Wwrt, Wwrt, Wwt, Wwt, Ds, Wwt, Ds, Wwt, Wwt, Wwt, Wwt, Ds, Ds, Wwt, Wwt, Wwt, Ds, Wwt, Ds, Ds, Dd^Ftd, Ds, Dd^Ftd, Wwt, Wwt, Wwt, Wwt, Wwt, Ds, Wwrt, Wwt, Wwrt, Wwrt, Wwt, Wwt, Wwrt, Wwrt, Wwrt, Ds, Ds, Ds, Ds, Gll^Ftr, Gll^Ftr, Gs^Ft, Gll^Ftr, Gs^Ft, Gll^Ftr
Wwt, Wwt, Wwt, Ds, Wwt, Wwrt, Wwt, Dd^Ftd, Wwrt, Wwt, Wwt, Wwt, Wwt, Wwt, Wwt, Wwt, Ds, Ds, Gs^Ft, Dd^Ftd, Gg^Efm, Gs^Ft, Gll^Ftr, Gs^Ft, Gs^Ft, Dd^Ftd, Ds, Ds, Dd^Ftd, Ds, Gs^Ftp, Dd^Ftd, Ds, Wwt, Wwt, Wwt, Wwt, Ds, Ds, Ds, Gll^Ftr, Gll^Ftr, Gll^Ftr, Gll^Ftr, Gll^Ftr, Gll^Ftr, Gs^Ft, Gg^Efm, Gs^Ft, Gs
Wot, Wwt, Wwt, Ds, Wwrt, Wwt, Wwt, Wwrt, Ds, Wwt, Ds, Ds, Ds, Wwt, Ds, Wwt, Dd^Ftd, Gs^Ft, Gll^Ftr, Gll^Ftr, Cdr, Gll^Ftr, Cdr, Gll^Ftr, Gll^Ftr, Gg^Efm, Gs^Ft, Gs^Ft, Gll^Ftr, Gs^Ftp, Gll^Ftr, Gll^Ftr, Gll^Ftr, Ds, Wwt, Wwt, Wwrt, Ds, Gll^Ftr, Gll^Ftr, Gll^Ftr, Gll^Ftr, Rb, Gll^Ftr, Gs^Vc, Gll^Ftr, Gs^Ft, Gg^Efm, Gs^Ft, Gll^Ftr
Wot, Wwt, Wwt, Wwrt, Ds, Ds, Dd^Ftd, Ds, Gs^Ft, Dd^Ftd, Gs^Ftp, Gs^Ft, Gs^Ftp, Dd^Ftd, Gs^Ft, Dd^Ftd, Gll^Ftr, Gll^Ftr, Gll^Ftr, Ce, Gll^Ftr, Gg^Efm, Cdr, Gll^Ftr, Cdr, Gg^Efm, Gg^Efm, Gs^Ft, Gs^Vdt, Gll^Ftr, Gll^Ftr, Gll^Ftr, Ds, Ds, Wwt, Wwt, Ds, Ds, Gll^Ftr, Gll^Ftr, Gll^Ftr, Gll^Ftr, Gs^Ft, Gll^Ftr, Gs^Vc, Gll^Ecf, Gs^Vc, Gll^Ftr, Gll^Ftr, Gll^Ftr
Wwt, Wwt, Wwt, Wwt, Ds, Gs^Ft, Gll^Ftr, Gs^Ftp, Gll^Ftr, Gll^Ftr, Gll^Ftr, Ss^Ftm, Gs^Ft, Gll^Ftr, Gll^Ftr, Gll^Ftr, Gll^Ftr, Ss^Ftm, Gs^Ft, Cdr, Gll^Ftr, Ce, Kdr, Kdr, Ce, Gll^Ftr, Gs^Ft, Gs^Ft, Gll^Ecf, Gs^Vdt, Gs^Ft, Gs^Ft, Wwrt, Wwt, Wwt, Wwrt, Gs^Ft, Gll^Ftr, Gll^Ftr, Gll^Ftr, Gll^Ftr, Gs^Ft, Gg^Efm, Gll^Ftr, Gll^Ftr, Gll^Ftr, Gll^Ftr, Gll^Ftr, Gll^Ftr, Gll^Ftr
Wwt, Wwt, Wwt, Ds, Gs^Ft, Gg^Efm, Cdr, Gll^Ftr, Gll^Ftr, Gs^Ft, Gg^Efm, Gs^Ft, Gg^Efm, Gg^Efm, Gs^Ft, Gll^Ftr, Gs^Vdt, Gs^Ft, Gg^Efm, Cdr, Gll^Ftr, Cdr, Ce, Cdr, Gs^Ft, Cdr, Ss, Gll^Ftr, Ss^Ftm, Ss, Gs^Ft, Ds, Wwt, Wwt, Ds, Ds, Ss^Ftm, Ss^Ftm, Gll^Ftr, Ss^Ftm, Gg^Fet, Gs^Ft, Gg^Efm, Gs^Ft, Gll^Ftr, Gll^Ftr, Gs^Ft, Gs^Ft, Gs^Ft, Gll^Ftr
Wwt, Wwt, Dd^Ftd, Dd^Ftd, Gs^Ftp, Gll^Ftr, Kdr, Cdr, Gll^Ftr, Gs^Ft, Gll^Ftr, Gg^Efm, Gs^Ft, Gg^Efm, Gll^Ftr, Gs^Vdt, Gll^Ecf, Gll^Ftr, Gs^Ft, Gs^Ft, Kdr, Gll^Ftr, Cdr, Gg^Efm, Gs^Ft, Gll^Ftr, Gll^Ftr, Ss, Ss, Ss, Ss, Wwrt, Wwt, Wwt, Ss^Ftm, Gs^Ft, Gg^Efm, Gs^Ft, Gll^Ftr, Ss^Ftm, Gll^Ftr, Gs^Ft, Gs^Ft, Gs^Ft, Gll^Ftr, Gs^Ft, Gg^Efm, Gg^Efm, Gg^Efm, Gll^Ftr
Ds, Ds, Gs^Ft, Gll^Ftr, Cdr, Gll^Ftr, Cdr, Gs^Ft, Rb, Gs^Vc, Gs^Vc, Gll^Ftr, Gll^Ftr, Gll^Ftr, Gll^Ftr, Gll^Ftr, Gll^Ftr, Gs^Vdt, Gll^Ftr, Gll^Ftr, Gll^Ftr, Gll^Ftr, Gll^Ftr, Gs^Ft, Gll^Ecf, Gs^Vdt, Gll^Ftr, Gs^Ft, Gg^Efm, Ss^Ftm, Wwrt, Wwt, Wwt, Ds, Gs^Ft, Gg^Efm, Gs^Ft, Gs^Ft, Mdd, Gll^Ftr, Gs^Ft, Gll^Ftr, Gll^Ftr, Cdr, Gs^Ft, Gll^Ftr, Gll^Ftr, Gs^Ft, Gs^Ft, Gs^Ft
Gs^Ftp, Gs^Ft, Gll^Ftr, Gll^Ftr, Gll^Ftr, Gll^Ftr, Gll^Ftr, Gll^Ftr, Gs^Ft, Gs^Ecf, Gll^Ftr, Gll^Ftr, Ss^Ftm, Ss^Ftm, Ss^Ftm, Ss^Ftm, Gll^Ftr, Gll^Ftr, Ss^Ftm, Ss^Ftm, Ss^Ftm, Ss^Ftm, Gll^Ftr, Gll^Ftr, Gs^Vdt, Gs^Vdt, Gll^Ftr, Gs^Ft, Gs^Ft, Ss^Ftm, Wwt, Wwt, Ds, Ss^Ftm, Gs^Ft, Gs^Ft, Ss^Ftm, Mdd, Mdd, Mdd, Gs^Ft, Cdr, Cdr, Cdr, Gll^Ftr, Cdr, Gll^Ftr, Gll^Ftr, Gll^Ftr, Gll^Ftr
Gll^Ftr, Gll^Ftr, Gll^Ftr, Gll^Ftr, Gll^Ftr, Gll^Ftr, Gll^Ftr, Gll^Ftr, Gll^Ftr, Gs^Ft, Gll^Ftr, Gs^Ft, Gg^Efm, Gs^Ft, Gll^Ftr, Gll^Ftr, Gll^Ftr, Gg^Efm, Gll^Ftr, Gll^Ftr, Gll^Ftr, Gll^Ftr, Gs^Ft, Gll^Ftr, Gs^Ft, Gll^Ftr, Gll^Ftr, Ss^Ftm, Gs^Ft, Gs^Ft, Wwt, Wwt, Wwt, Gs^Ft, Gg^Efm, Ss^Ftm, Ss^Ftm, Gll^Ftr, Gll^Ftr, Gll^Ftr, Gll^Ftr, Kdr, Gll^Ftr, Kdr, Cdr, Gs^Ft, Gs^Ft, Gll^Ftr, Gll^Ftr, Gll^Ftr
Gg^Efm, Gs^Ftp, Gs^Ftp, Ss^Ftm, Gll^Ftr, Gll^Ftr, Ss^Ftm, Ss^Ftm, Gg^Efm, Ss^Ftm, Gll^Ftr, Gs^Ft, Gg^Efm, Gs^Ft, Gs^Ftp, Gs^Ftp, Gg^Efm, Gs^Ftp, Gll^Ftr, Gll^Ftr, Gs^Ft, Ss^Ftm, Gs^Ft, Gg^Efm, Gs^Ft, Gll^Ftr, Gll^Ftr, Ss^Ftm, Gs^Ft, Ss^Ftm, Ds, Wwt, Wwt, Ds, Ds, Gs^Ft, Gll^Ftr, Gg^Fet, Ss^Ftm, Gs^Ft, Ss, Cdr, Gg^Efm, Cdr, Gll^Ftr, Gg^Efm, Gg^Efm, Gs^Ft, Gll^Ftr, Gll^Ftr
Gg^Efm, Gg^Efm, Gll^Ftr, Gll^Ftr, Gll^Ftr, Gll^Ftr, Gll^Ftr, Gg^Efm, Gll^Ftr, Gll^Ftr, Gll^Ftr, Gll^Ftr, Gs^Ft, Gg^Efm, Gll^Ftr, Gg^Efm, Gs^Ftp, Gs^Ftp, Gll^Ftr, Gg^Efm, Gg^Efm, Gs^Ft, Gll^Ftr, Gg^Efm, Gll^Ftr, Gll^Ftr, Mdd, Mdd, Mdd, Gll^Ftr, Gs^Ft, Wwt, Wwt, Wwt, Wwt, Wwt, Wwt, Ss^Ftm, Wwt, Wwt, Gs^Ftp, Ss, Gs^Ft, Gll^Ftr, Gs^Ft, Gs^Ft, Gs^Ft, Gs^Ft, Gll^Ftr, Gll^Ftr
Gll^Ftr, Gs^Ftp, Mdd, Mdd, Mdd, Gs^Ft, Gg^Efm, Gg^Efm, Ss^Ftm, Gs^Ft, Gg^Efm, Gll^Ftr, Gs^Ft, Gs^Ft, Ss^Ftm, Ss^Ftm, Gll^Ftr, Gll^Ftr, Gg^Fet, Gs^Ft, Gg^Efm, Gg^Efm, Gs^Ft, Gs^Ft, Gg^Fet, Gll^Ftr, Gs^Ft, Mdd, Mdd, Mdd, Mdd, Ss^Ftm, Gs^Ft, Wwt, Wwt, Wwt, Wwt, Wwt, Ds, Gg^Efm, Gll^Ftr, Gll^Ftr, Gs^Ft, Gg^Efm, Gg^Efm, Gll^Ftr, Gll^Ecf, Gll^Ftr, Gll^Ftr, Gll^Ftr
Gll^Ftr, Gll^Ftr, Gll^Ftr, Mdd, Gll^Ftr, Gll^Ftr, Gll^Ftr, Gs^Ft, Gll^Ftr, Gll^Ftr, Gll^Ftr, Gg^Efm, Gs^Ftp, Gll^Ftr, Gg^Efm, Gg^Efm, Gs^Ft, Gll^Ftr, Gs^Ft, Ss^Ftm, Gs^Ft, Gg^Efm, Gg^Efm, Ss^Ftm, Gll^Ftr, Gs^Ft, Gg^Efm, Gg^Efm, Gg^Efm, Mdd, Gll^Ftr, Gs^Ft, Mdd, Gg^Efm, Gs^Ft, Ds, Wwt, Wwt, Wwt, Ss^Ftm, Gll^Ftr, Gll^Ftr, Gll^Ftr, Gg^Efm, Gs^Ft, Gs^Ft, Gs^Vc, Gs^Vc, Gll^Ftr, Gll^Ftr
Ss, Gll^Ftr, Ss^Ftm, Gll^Ftr, Gll^Ftr, Gs^Ft, Gg^Efm, Gll^Ftr, Mdd, Mdd, Mdd, Gll^Ftr, Gll^Ftr, Ss^Ftm, Gs^Ft, Gg^Efm, Gg^Efm, Gg^Efm, Gg^Efm, Gll^Ftr, Gs^Vc, Gll^Ftr, Gll^Ftr, Gs^Ft, Gs^Ft, Gg^Efm, Gs^Ftp, Gg^Efm, Mdd, Gll^Ftr, Mdd, Mdd, Mdd, Mdd, Mdd, Gll^Ftr, Ss^Ftm, Wwt, Wwt, Wwt, Ss^Ftm, Gs^Ft, Gg^Efm, Gs^Ft, Gll^Ftr, Gll^Ftr, Gll^Ftr, Gll^Ftr, Gll^Ftr, Gll^Ftr
Gs^Ft, Gs^Ft, Gg^Efm, Gs^Ft, Ss^Ftm, Gs^Ft, Gg^Efm, Gs^Ft, Gll^Ftr, Mdd, Mdd, Mdd, Mdd, Gll^Ftr, Gg^Efm, Gs^Ft, Gll^Ftr, Gs^Ft, Gll^Ftr, Gll^Ftr, Gs^Vc, Gll^Ecf, Gs^Vc, Ss^Ftm, Gll^Ftr, Ss^Ftm, Mdd, Mdd, Mdd, Mdd, Mdd, Mdd, Mdd, Mdd, Mdd, Mdd, Gll^Ftr, Ss^Ftm, Wwt, Wwt, Wwt, Gg^Efm, Gs^Ft, Gll^Ftr, Gll^Ftr, Gll^Ftr, Gll^Ftr, Gs^Ft, Gll^Ftr, Gll^Ftr
Gll^Ftr, Gg^Efm, Gs^Ft, Gg^Efm, Ss^Ftm, Gll^Ftr, Gs^Ft, Gg^Efm, Gg^Efm, Gll^Ftr, Gll^Ftr, Mdd, Gll^Ftr, Gs^Ftp, Gs^Ftp, Gll^Ftr, Gs^Ft, Ss^Ftm, Gs^Ft, Gll^Ftr, Gll^Ftr, Gll^Ftr, Ss^Ftm, Gll^Ftr, Gll^Ftr, Gs^Ft, Gg^Efm, Gll^Ftr, Gll^Ftr, Mdd, Mdd, Mdd, Mdd, Gll^Ftr, Gll^Ftr, Gll^Ftr, Ss^Ftm, Gll^Ftr, Ss^Ftm, Wwt, Wwt, Gg^Efm, Gs^Ft, Gs^Ft, Gg^Efm, Gs^Ft, Gs^Ft, Gll^Ftr, Ss^Ftm, Gll^Ftr
Gll^Ftr, Ss^Ftm, Ss^Ftm, Gll^Ftr, Gll^Ftr, Ss^Ftm, Gs^Ft, Gg^Efm, Gs^Ft, Gg^Efm, Gll^Ftr, Gll^Ftr, Gs^Ft, Gg^Efm, Mdd, Mdd, Mdd, Gg^Fet, Gg^Efm, Gg^Efm, Gs^Ft, Gll^Ftr, Gll^Ftr, Gll^Ftr, Gs^Ft, Gg^Efm, Gg^Efm, Gs^Ft, Gll^Ftr, Mdd, Mdd, Mdd, Mdd, Mdd, Mdd, Gll^Ftr, Ss^Ftm, Gs^Ft, Ss^Ftm, Wwt, Wwt, Ss^Ftm, Wwt, Gs^Ft, Gg^Efm, Gg^Efm, Gs^Ft, Gll^Ftr, Gll^Ftr, Ss^Ftm
Gll^Ftr, Ss^Ftm, Gll^Ftr, Gll^Ftr, Gs^Ft, Gg^Efm, Gg^Efm, Gs^Ftp, Gll^Ftr, Gll^Ftr, Gll^Ftr, Cdr, Gll^Ftr, Gs^Ft, Gll^Ftr, Mdd, Gs^Ft, Gs^Ft, Gg^Efm, Gg^Efm, Gll^Ftr, Ss^Ftm, Gll^Ftr, Ss^Ftm, Gs^Ft, Gg^Efm, Gs^Ft, Ss^Ftm, Gg^Efm, Gs^Ft, Gs^Ft, Mdd, Gll^Ftr, Mdd, Gs^Ft, Ss^Ftm, Gs^Ft, Gs^Ft, Wwt, Wwt, Ss^Ftm, Wwt, Gll^Ftr, Wwf, Ss^Ftm, Gg^Efm, Gs^Vc, Gs^Ft, Gll^Ftr, Gll^Ftr
Gll^Ftr, Gll^Ftr, Ss^Ftm, Ss^Ftm, Gg^Efm, Gg^Efm, Gs^Ft, Gll^Ftr, Gll^Ftr, Gg^Fet, Gll^Ftr, Cdr, Kdr, Cdr, Gll^Ftr, Gs^Ft, Gg^Efm, Gg^Efm, Gs^Ft, Gs^Ftp, Gg^Efm, Gll^Ftr, Gll^Ftr, Gll^Ftr, Gg^Efm, Gg^Efm, Gs^Ft, Gll^Ftr, Gg^Efm, Gg^Efm, Gg^Efm, Gll^Ftr, Gs^Ft, Gll^Ftr, Wwt, Ss^Ftm, Wwt, Wwt, Wwt, Wwt, Gll^Ftr, Gs^Ft, Gg^Efm, Gs^Ft, Gs^Ft, Gs^Ecf, Gg^Efm, Gs^Ft, Gll^Ftr, Gll^Ftr
Gll^Ftr, Gll^Ftr, Gll^Ftr, Gs^Ft, Gg^Efm, Gs^Ft, Gll^Ftr, Ss^Ftm, Gs^Ft, Gs^Ft, Gg^Efm, Gll^Ftr, Cdr, Gll^Ftr, Gs^Ftp, Mdd, Mdd, Gs^Ftp, Ss^Ftm, Gs^Ft, Gg^Efm, Gs^Ft, Gs^Ft, Gll^Ftr, Gll^Ftr, Gll^Ftr, Gs^Ft, Gll^Ftr, Gll^Ftr, Gs^Ft, Gll^Ftr, Gs^Ft, Wwt, Wwt, Wwt, Wwt, Ss, Wwt, Ss, Ss, Gs^Ft, Gll^Ftr, Gs^Ft, Gg^Efm, Gll^Ftr, Gs^Ft, Gll^Ftr, Gs^Ft, Gll^Ftr, Gll^Ftr
Ss^Ftm, Ss^Ftm, Gll^Ftr, Ss, Gs^Ft, Gs^Ft, Ss^Ftm, Gll^Ftr, Ss^Ftm, Gg^Efm, Gg^Efm, Gs^Ft, Ss, Gg^Efm, Ss^Ftm, Gg^Efm, Gs^Ftp, Mdd, Ss^Ftm, Gll^Ftr, Ss^Ftm, Gg^Efm, Wwt, Wwt, Wwt, Ss^Ftm, Wwt, Gs^Ft, Ss^Ftm, Ss^Ftm, Ss^Ftm, Gs^Ft, Wwt^Bw\r, Wwt, Gs^Ft, Gs^Ft, Gg^Efm, Gs^Ft, Gs^Ft, Gg^Efm, Gg^Efm, Gs^Ft, Gs^Ft, Gg^Efm, Gg^Efm, Gs^Ft, Gll^Ftr, Gg^Fet, Gll^Ftr, Gll^Ftr
Gll^Ftr, Gll^Ftr, Gs^Vc, Gll^Ftr, Gs^Vc, Gs^Ftp, Gg^Efm, Gg^Efm, Ss^Ftm, Gs^Ftp, Ss^Ftm, Gs^Ft, Ss, Gs^Ftp, Wwt, Ss^Ftm, Wwt, Wwt, Wwt, Wwt, Wwt, Ss, Wwt, Wwt, Wwt, Wwt^Bw|r, Wwt, Wwt, Wwt, Wwt, Wwt, Wwt, Wwt, Gg^Efm, Gg^Efm, Gs^Ft, Mdd, Gll^Ftr, Gll^Ftr, Ss, Gll^Ftr, Ss, Gll^Ftr, Gs^Ft, Gs^Ft, Gs^Ft, Gs^Ft, Gll^Ftr, Gll^Ftr, Gll^Ftr
Gll^Ftr, Gll^Ftr, Gll^Ftr, Gs^Ecf, Gs^Vc, Gs^Ftp, Ss^Ftm, Gs^Ftp, Wwt, Gs^Ft, Ss^Ftm, Gs^Ftp, Ss, Wwt^Bw|r, Ss^Ftm, Wwt, Mdd, Gll^Ftr, Gll^Ftr, Wwt, Gll^Ftr, Ss^Ftm, Gs^Ft, Gs^Ft, Gg^Efm, Ss^Ftm, Gs^Ft, Wwt, Gg^Efm, Wwt, Ss^Ftm, Wwt, Gs^Ft, Gs^Ft, Gs^Ft, Mdd, Mdd, Mdd, Gll^Ftr, Cdr, Cdr, Cdr, Gll^Ftr, Gll^Ftr, Gs^Ft, Gg^Efm, Gs^Ft, Gll^Ftr, Gll^Ftr, Gll^Ftr
Gll^Ftr, Gll^Ftr, Gll^Ftr, Gs^Ft, Gs^Ft, Gll^Ftr, Gs^Ftp, Wwt, Ss^Ftm, Wwt, Wwt, Wwt, Gs^Ftp, Ss^Ftm, Gll^Ftr, Gs^Ft, Mdd, Mdd, Mdd, Gll^Ftr, Mdd, Mdd, Mdd, Ss^Ftm, Gg^Efm, Gg^Efm, Gs^Ft, Gs^Ft, Ss^Ftm, Gg^Efm, Gs^Ft, Wwt, Gll^Ftr, Mdd, Mdd, Gll^Ftr, Gll^Ftr, Gll^Ftr, Cdr, Gll^Ftr, Cdr, Kdr, Cdr, Gll^Ftr, Gs^Ft, Gg^Efm, Gs^Vc, Gs^Ft, Gll^Ftr, Gll^Ftr
Gll^Ftr, Gll^Ftr, Gs^Ft, Gg^Efm, Gg^Efm, Gll^Ftr, Gg^Efm, Gs^Ft, Gs^Ft, Ss^Ftm, Wwt, Ss^Ftm, Gs^Vc, Gg^Efm, Rb, Gll^Ftr, Gll^Ftr, Mdd, Mdd, Gll^Ftr, Gll^Ftr, Mdd, Gll^Ftr, Gll^Ftr, Gs^Ft, Gg^Efm, Ss^Ftm, Gll^Ftr, Gg^Fet, Gll^Ftr, Gs^Ftp, Ss^Bw/r, Wwt, Gs^Ftp, Gll^Ftr, Mdd, Gll^Ftr, Gll^Ftr, Cdr, Gll^Ftr, Kdr, Gll^Ftr, Gll^Ftr, Gll^Ftr, Gs^Ft, Gs^Vc, Gll^Ecf, Gll^Ftr, Gll^Ftr, Gll^Ftr
Gll^Ftr, Gs^Ft, Gg^Efm, Gg^Efm, Gs^Ft, Gll^Ftr, Gll^Ftr, Gs^Ft, Gg^Efm, Wwt, Ss^Ftm, Ss^Ftm, Gll^Ecf, Gs^Vc, Gll^Ftr, Gll^Ftr, Gs^Ft, Gll^Ftr, Gg^Efm, Gll^Ftr, Mdd, Gs^Ft, Gg^Efm, Gs^Ft, Gll^Ftr, Gll^Ftr, Ss^Ftm, Ss^Ftm, Gll^Ftr, Gll^Ftr, Gll^Ftr, Wwt, Wwt, Gll^Ftr, Mdd, Mdd, Mdd, Gll^Ftr, Gll^Ftr, Rb, Cdr, Cdr, Ss^Ftm, Gll^Ftr, Gll^Ftr, Gs^Vc, Gg^Efm, Gs^Ft, Gs^Ft, Gll^Ftr
Gll^Ftr, Gs^Ft, Gg^Efm, Gg^Efm, Gll^Ftr, Gll^Ftr, Mdd, Gll^Ftr, Gll^Ftr, Wwt, Gg^Efm, Gll^Ftr, Gs^Ft, Gll^Ftr, Gs^Ft, Gg^Efm, Gs^Ft, Gg^Efm, Gll^Ftr, Gll^Ftr, Mdd, Mdd, Mdd, Gg^Efm, Gll^Ftr, Gg^Efm, Gg^Efm, Gs^Ft, Gs^Ft, Gll^Ecf, Gs^Vc, Gs^Ftp, Wwt, Gs^Ft, Mdd, Mdd, Mdd, Mdd, Mdd, Gll^Ftr, Gll^Ftr, Gll^Ftr, Gll^Ftr, Gll^Ftr, Gll^Ftr, Gs^Ft, Gg^Efm, Gg^Efm, Gs^Ft, Gll^Ftr
Gll^Ftr, Gll^Ftr, Gs^Ft, Gll^Ftr, Gll^Ftr, Mdd, Mdd, Mdd, Gs^Ft, Wwt, Ss, Gs^Ft, Gg^Efm, Gs^Ft, Gll^Ftr, Gg^Efm, Gll^Ftr, Gs^Ft, Gs^Ft, Gll^Ftr, Gll^Ftr, Mdd, Mdd, Gll^Ftr, Mdd, Mdd, Gs^Ft, Gg^Efm, Gs^Ft, Gll^Ftr, Ss^Ftm, Ss^Ftm, Gll^Ftr, Wwt, Wwt, Mdd, Mdd, Mdd, Gll^Ftr, Gg^Fet, Mdd, Mdd, Mdd, Gll^Ftr, Gs^Ft, Gs^Ft, Gs^Ft, Gs^Ft, Gll^Ftr, Gll^Ftr
Gll^Ftr, Gs^Ft, Gll^Ftr, Gg^Efm, Gg^Fet, Gll^Ftr, Gll^Ftr, Gll^Ftr, Wwt, Wwt, Gs^Ft, Ss, Cdr, Gll^Ftr, Cdr, Gll^Ftr, Gs^Ft, Gg^Efm, Gg^Efm, Gs^Ft, Gs^Ft, Gll^Ftr, Gll^Ftr, Mdd, Gll^Ftr, Gll^Ftr, Gg^Efm, Gg^Efm, Gs^Ft, Gll^Ftr, Ss^Ftm, Ss^Ftm, Gll^Ftr, Wwt, Wwt, Gs^Ft, Gll^Ftr, Gll^Ftr, Ss^Ftm, Gll^Ftr, Gll^Ftr, Mdd, Gs^Ft, Gg^Efm, Gg^Efm, Gs^Ft, Gll^Ftr, Gll^Ftr, Gll^Ftr, Gll^Ftr
Gll^Ftr, Gs^Ft, Gll^Ftr, Gg^Efm, Gg^Efm, Gll^Ftr, Gs^Ft, Gll^Ftr, Ss^Ftm, Ss, Cdr, Gll^Ftr, Cdr, Gll^Ftr, Gll^Ftr, Gll^Ftr, Gs^Ft, Gs^Ft, Gll^Ftr, Gll^Ftr, Gs^Ft, Gg^Efm, Mdd, Mdd, Mdd, Gs^Ft, Gs^Ft, Gg^Efm, Gll^Ftr, Ss^Ftm, Gll^Ftr, Gll^Ftr, Ss^Ftm, Gs^Ft, Gll^Ftr, Ss^Bw/r, Ss^Ftm, Ss^Ftm, Gll^Ftr, Gs^Ft, Gg^Efm, Gll^Ftr, Gg^Efm, Gg^Efm, Gs^Ft, Gs^Ft, Ss^Ftm, Ss, Ss^Ftm, Gll^Ftr
Gll^Ftr, Gll^Ftr, Gs^Ft, Gs^Ft, Gg^Efm, Gg^Efm, Gs^Ft, Gg^Efm, Gg^Efm, Gs^Ft, Gll^Ftr, Cdr, Rb, Kdr, Cdr, Gll^Ftr, Gg^Efm, Gs^Ft, Gs^Vc, Gs^Vc, Gll^Ftr, Gs^Ft, Gll^Ftr, Mdd, Mdd, Mdd, Gll^Ftr, Gll^Ftr, Ss^Ftm, Gll^Ftr, Gs^Ft, Gll^Ftr, Ss^Ftm, Ss^Ftm, Gs^Ft, Ss, Gll^Ftr, Gg^Efm, Gs^Ft, Gg^Efm, Gs^Ft, Gs^Ft, Gg^Efm, Gs^Ft, Gll^Ftr, Gll^Ftr, Gll^Ftr, Ss^Ftm, Gll^Ftr, Ss
Gll^Ftr, Gll^Ftr, Gll^Ftr, Gs^Ft, Gs^Ftp, Gll^Ftr, Gll^Ftr, Gg^Efm, Gs^Ft, Gg^Efm, Gll^Ftr, Kdr, Gll^Ftr, Cdr, Gll^Ftr, Gs^Ft, Gs^Ft, Gll^Ftr, Gll^Ftr, Gll^Ecf, Gs^Ft, Gg^Efm, Gll^Ftr, Mdd, Gll^Ftr, Gll^Ftr, Gs^Ft, Gs^Ft, Gg^Efm, Gg^Efm, Gg^Efm, Gs^Ft, Gs^Ft, Ss^Ftm, Wwt, Wwt, Ss^Ftm, Ss, Gs^Ft, Gs^Ft, Gll^Ftr, Gs^Ft, Gs^Ft, Gg^Efm, Gs^Ft, Gll^Ftr, Ss, Ss^Ftm, Ss^Ftm, Ss
Ss, Ss, Gs^Ft, Gg^Efm, Gs^Ft, Gll^Ftr, Gll^Ftr, Gll^Ftr, Gll^Ftr, Gs^Ft, Gll^Ftr, Cdr, Gll^Ftr, Cdr, Gll^Ftr, Gll^Ftr, Gll^Ftr, Gll^Ftr, Gs^Ft, Gll^Ftr, Gs^Ft, Gs^Ft, Mdd, Gll^Ftr, Gll^Ftr, Ss^Ftm, Gg^Efm, Ss^Ftm, Gs^Ftp, Gg^Efm, Gs^Ftp, Gg^Efm, Gs^Ft, Ss^Ftm, Wwt, Wwt, Wwt, Gs^Ft, Ss^Ftm, Gg^Efm, Gll^Ftr, Gll^Ftr, Gs^Ft, Gs^Ft, Gll^Ftr, Gll^Ftr, Gll^Ftr, Gll^Ftr, Gll^Ftr, Gll^Ftr
Ss, Ss^Ftm, Gll^Ftr, Gg^Efm, Gg^Efm, Gll^Ftr, Gs^Ftp, Gll^Ftr, Gs^Ft, Gs^Ft, Gg^Efm, Gll^Ftr, Gll^Ftr, Gll^Ftr, Gg^Efm, Gs^Ft, Gg^Fet, Gll^Ftr, Mdd, Gg^Efm, Gll^Ftr, Mdd, Mdd, Mdd, Gs^Ft, Gs^Ftp, Ss^Ftm, Gg^Efm, Ss^Ftm, Ss^Ftm, Ss^Ftm, Ss^Ftm, Wwt, Wwt, Gs^Ft, Gs^Ftp, Wwt, Ss^Ftm, Gs^Ftp, Gg^Efm, Gll^Ftr, Gs^Ft, Gg^Efm, Gg^Efm, Gs^Ft, Mdd, Ss^Ftm, Gll^Ftr, Ss, Ss
Gll^Ftr, Ss, Gll^Ftr, Gs^Ft, Gs^Ft, Gs^Ft, Gg^Efm, Gs^Ftp, Gs^Ft, Gg^Efm, Gll^Ftr, Gs^Ft, Gll^Ftr, Gs^Ft, Gg^Efm, Gs^Ft, Gll^Ftr, Gll^Ftr, Mdd, Mdd, Mdd, Gll^Ftr, Gs^Ftp, Gll^Ftr, Gs^Ft, Gg^Efm, Gg^Efm, Ss^Ftm, Gg^Fet, Ss^Ftm, Gs^Ftp, Gg^Efm, Ss^Ftm, Ss^Ftm, Gg^Efm, Ss^Ftm, Gg^Efm, Ss, Wwt, Gs^Ft, Gg^Efm, Gs^Ftp, Gs^Ft, Gs^Ft, Gll^Ftr, Gll^Ftr, Ss^Ftm, Ss^Ftm, Gll^Ftr, Gll^Ftr
Gll^Ftr, Gll^Ftr, Gs^Ft, Gll^Ftr, Gg^Efm, Gg^Efm, Gll^Ftr, Gll^Ftr, Gs^Vc, Gll^Ftr, Gs^Ft, Gs^Ft, Ss^Ftm, Ss^Ftm, Gs^Ftp, Gg^Efm, Gll^Ftr, Mdd, Mdd, Mdd, Gll^Ftr, Gll^Ftr, Gs^Ft, Gg^Efm, Gg^Efm, Gg^Efm, Gs^Ft, Gll^Ftr, Gll^Ftr, Ss^Ftm, Ss^Ftm, Ss^Ftm, Gg^Efm, Gs^Ftp, Gs^Ft, Gs^Ft, Gll^Ftr, Gs^Ft, Wwt, Wwt, Wwt, Gg^Efm, Gll^Ftr, Gg^Fet, Gll^Ftr, Gs^Ft, Gs^Ft, Gll^Ftr, Ss^Ftm, Ss^Ftm
Gll^Ftr, Gll^Ftr, Gs^Ft, Gg^Efm, Gg^Efm, Gg^Efm, Gs^Ft, Gs^Vc, Gll^Ecf, Gs^Vc, Gg^Efm, Gg^Efm, Gg^Efm, Gs^Ft, Gll^Ftr, Gs^Ftp, Gll^Ftr, Gll^Ftr, Gs^Ft, Gll^Ftr, Gs^Ft, Gll^Ftr, Gs^Ftp, Gg^Efm, Gs^Ftp, Gs^Ftp, Gll^Ftr, Gll^Ftr, Mdd, Mdd, Gll^Ftr, Gs^Ft, Gg^Efm, Gg^Efm, Gll^Ftr, Qxe, Qxe, Gg^Efm, Gg^Efm, Gs^Ft, Gs^Ft, Gll^Ftr, Gg^Efm, Gll^Ftr, Gs^Ft, Gg^Efm, Gg^Efm, Gs^Ft, Gll^Ftr, Gll^Ftr
Gll^Ftr, Ss^Ftm, Gll^Ftr, Ss^Ftm, Gs^Ft, Gs^Ft, Gll^Ftr, Gs^Vc, Gll^Ftr, Gg^Efm, Gs^Ft, Gg^Efm, Gs^Ft, Gg^Efm, Gll^Ftr, Gll^Ftr, Gll^Ftr, Gll^Ftr, Gs^Ft, Gg^Efm, Gll^Ftr, Gs^Ft, Gs^Ft, Gs^Ft, Ss^Ftm, Ss^Ftm, Qxe, Mdd, Qxe, Qxe, Qxe, Gll^Ftr, Gll^Ftr, Gs^Ft, Gll^Ftr, Qxe, Qxe, Gs^Ft, Gs^Ft, Gg^Efm, Gll^Ftr, Gll^Ftr, Gll^Ftr, Gg^Efm, Gs^Ft, Gg^Efm, Gg^Efm, Gs^Ft, Gll^Ftr, Gll^Ftr
Gll^Ftr, Gll^Ftr, Gs^Ft, Gs^Ft, Gs^Ft, Gll^Ftr, Gs^Ft, Gll^Ftr, Gs^Ft, Gll^Ftr, Gs^Ft, Gll^Ftr, Gll^Ftr, Gs^Ft, Gg^Efm, Gs^Ft, Gg^Efm, Gs^Ft, Gs^Ftp, Gg^Efm, Gs^Vc, Gs^Ecf, Gs^Ft, Gll^Ftr, Gll^Ftr, Gll^Ftr, Qxe, Qxe, Gd^Fts, Gd^Fts, Hhd, Cdr, Kdr, Cdr, Cdr, Gll^Ftr, Gll^Ftr, Gll^Ftr, Qxe, Gll^Ftr, Gs^Ft, Gs^Ft, Gg^Efm, Gll^Ftr, Gs^Ft, Gs^Ft, Gs^Vc, Gs^Vc, Gs^Ft, Gll^Ftr
Gll^Ftr, Gll^Ftr, Gs^Ft, Gg^Efm, Mdd, Gg^Efm, Gg^Efm, Gs^Ftp, Gs^Ft, Gg^Efm, Gg^Efm, Gs^Ft, Gll^Ftr, Gs^Ft, Gs^Ft, Gg^Efm, Gs^Ft, Gg^Efm, Gll^Ftr, Gs^Ft, Gg^Efm, Gs^Vc, Qxe, Gll^Ftr, Cdr, Qxe, Gd^Fts, Gll^Fdw, Hhd, Mdd, Mdd, Hhd, Gd^Fts, Gll^Fdw, Hhd, Gll^Ftr, Mdd, Gll^Ftr, Gll^Ftr, Qxe, Gg^Efm, Gg^Efm, Gg^Efm, Gg^Efm, Gll^Ftr, Gll^Ftr, Gg^Efm, Gll^Ecf, Gll^Ftr, Gll^Ftr
Gll^Ftr, Gs^Ft, Gg^Efm, Mdd, Mdd, Mdd, Gs^Ft, Gs^Ft, Gll^Ftr, Gg^Efm, Gg^Efm, Gs^Ft, Gs^Ft, Ss^Ftm, Gg^Fet, Gs^Ft, Ss^Ftm, Gs^Ft, Gll^Ftr, Gll^Ftr, Qxe, Gg^Efm, Gd^Fts, Cdr, Gd, Hhd, Mdd, Mdd, Mdd, Hhd, Qxe, Mdd, Qxe, Gll^Fdw, Mdd, Mdd, Gd^Fts, Gll^Ftr, Gg^Efm, Gs^Ft, Gll^Ftr, Gs^Ft, Gs^Ftp, Gs^Ft, Gll^Ftr, Gs^Ft, Gs^Ft, Gs^Ft, Gll^Ftr, Gll^Ftr
Gll^Ftr, Gs^Ft, Gg^Efm, Gll^Ftr, Gll^Ftr, Gll^Ftr, Gll^Ftr, Gll^Ftr, Gll^Ftr, Gs^Ft, Gs^Ft, Gg^Efm, Gs^Ftp, Ss^Ftm, Gll^Ftr, Ss^Ftm, Gll^Ftr, Ss^Ftm, Gs^Ft, Gll^Ftr, Qxe, Gd^Fts, Gd, Gll^Fdw, Mdd, Gd, Gd, Mdd, Gll^Fdw, Gd^Fts, Gd^Fts, Qxe, Qxe, Gd, Gd, Hhd, Cdr, Gll^Ftr, Gg^Efm, Qxe, Qxe, Gll^Ftr, Gs^Ft, Gg^Efm, Gs^Ft, Gll^Ftr, Gll^Ftr, Gs^Ft, Gg^Efm, Gs^Ft
Gll^Ftr, Gll^Ftr, Gs^Ftp, Gs^Ft, Gs^Ft, Gs^Ft, Gs^Ft, Gll^Ftr, Mdd, Mdd, Mdd, Gg^Efm, Gs^Ftp, Gll^Ftr, Gll^Ftr, Gs^Ft, Gs^Ft, Gs^Ftp, Gg^Efm, Gs^Ft, Gll^Ftr, Cdr, Gd, Mdd, Mdd, Mdd, Hhd, Hhd, Cdr, Cdr, Mdd, Hhd, Hhd, Gd, Gll^Fdw, Cdr, Kdr, Gs^Ft, Gg^Efm, Qxe, Qxe, Qxe, Gll^Ftr, Gg^Efm, Gg^Efm, Gs^Ft, Gg^Efm, Gs^Ft, Gs^Ft, Gg^Efm
Gll^Ftr, Ss, Gs^Ft, Gll^Ftr, Gg^Efm, Gg^Efm, Gs^Ft, Gll^Ftr, Gll^Ftr, Mdd, Gll^Ftr, Gs^Ft, Gll^Ftr, Gll^Ftr, Gs^Ftp, Gg^Efm, Gg^Efm, Gg^Efm, Gg^Efm, Gg^Efm, Gs^Ft, Kdr, Cdr, Hhd, Qxe, Gll^Fdw, Mdd, Hhd, Kdr, Kdr, Kdr, Cdr, Mdd, Gd, Gd^Fts, Cdr, Hhd, Gg^Efm, Gs^Ft, Gs^Ft, Qxe, Qxe, Gll^Ftr, Gll^Ftr, Gg^Efm, Gs^Ft, Gs^Ftp, Gs^Ftp, Gll^Ftr, Gs^Ftp
Gll^Ftr, Gll^Ftr, Gs^Ft, Rb, Gs^Vc, Gs^Ft, Gll^Ftr, Gs^Ft, Gs^Ftp, Gll^Ftr, Gs^Ft, Gll^Ftr, Gll^Ftr, Gll^Ftr, Gs^Ftp, Gg^Efm, Gs^Ft, Gs^Ftp, Gll^Ftr, Qxe, Gll^Ftr, Cdr, Gd^Fts, Qxe, Qxe, Gd^Fts, Mdd, Cdr, Kdr, Km, Kdr, Cdr, Mdd, Gll^Fdw, Qxe, Gd^Fts, Gd^Fts, Cdr, Gll^Ftr, Gll^Ftr, Qxe, Gll^Ftr, Gs^Ft, Gs^Ft, Gll^Ftr, Gs^Ftp, Gs^Vc, Gll^Ftr, Gll^Ftr, Gll^Ftr
Gll^Ftr, Gs^Ft, Gg^Efm, Gs^Vc, Gll^Ecf, Gs^Ft, Gs^Ftp, Gg^Efm, Gs^Ftp, Gg^Efm, Gg^Efm, Gs^Ft, Gs^Ft, Gll^Ftr, Gs^Ft, Gll^Ftr, Gll^Ftr, Gll^Ftr, Gg^Fet, Gll^Ftr, Gll^Ftr, Gd^Fts, Mdd, Gd^Fts, Hhd, Hhd, Qxe, Mdd, Cdr, Kdr, Mdd, Cdr, Hhd, Gll^Fdw, Qxe, Hhd, Cdr, Cdr, Gll^Ftr, Qxe, Gll^Ftr, Gll^Ftr, Gg^Efm, Gll^Ftr, Gs^Vc, Gll^Ecf, Gll^Ftr, Gll^Ftr, Gll^Ftr, Gll^Ftr
Gll^Ftr, Gs^Ft, Gs^Ft, Gg^Efm, Gs^Ft, Gs^Ft, Ss^Ftm, Gs^Ft, Ss^Ftm, Gs^Ft, Ss^Ftm, Gll^Ftr, Gs^Ft, Gg^Efm, Gs^Ecf, Gs^Vc, Gs^Ft, Gll^Ftr, Gll^Ftr, Qxe, Qxe, Mdd, Mdd, Mdd, Cdr, Qxe, Gd^Fts, Hhd, Hhd, Mdd, Qxe, Mdd, Qxe, Gd, Gd, Gll^Fdw, Gll^Ftr, Gll^Ftr, Gll^Ftr, Qxe, Gll^Ftr, Gs^Ft, Gs^Ft, Gs^Ftp, Gll^Ftr, Gs^Vc, Gll^Ftr, Rb, Gll^Ftr, Gll^Ftr
Gll^Ftr, Gll^Ftr, Gll^Ftr, Gs^Ft, Gll^Ftr, Ss^Ftm, Gll^Ftr, Ss^Ftm, Ss^Ftm, Ss^Ftm, Gs^Ft, Gll^Ftr, Gs^Ft, Gg^Efm, Gg^Efm, Gs^Vc, Gs^Ft, Gll^Ftr, Gll^Ftr, Gll^Ftr, Qxe, Gll^Ftr, Gll^Ftr, Gd^Fts, Gd^Fts, Gd^Fts, Mdd, Mdd, Mdd, Gd^Fts, Qxe, Gd^Fts, Gll^Fdw, Gd, Mdd, Mdd, Gll^Ftr, Ss^Ftm, Ss^Ftm, Ss^Ftm, Ss^Ftm, Gs^Ft, Gs^Ft, Gll^Ftr, Gll^Ftr, Gll^Ftr, Gll^Ftr, Gll^Ftr, Gs^Ft, Gll^Ftr
Gll^Ftr, Gll^Ftr, Gll^Ftr, Gll^Ftr, Gll^Ftr, Gll^Ftr, Gll^Ftr, Gll^Ftr, Gll^Ftr, Ss^Ftm, Gll^Ftr, Gll^Ftr, Gll^Ftr, Gll^Ftr, Gll^Ftr, Gs^Ft, Gll^Ftr, Gll^Ftr, Gll^Ftr, Gll^Ftr, Gll^Ftr, Gll^Ftr, Ss, Gll^Ftr, Gll^Ftr, Cdr, Gll^Ftr, Mdd, Gll^Ftr, Gll^Ftr, Gll^Ftr, Cdr, Gll^Ftr, Mdd, Gll^Ftr, Gll^Ftr, Gll^Ftr, Ss^Ftm, Gll^Ftr, Ss^Ftm, Gll^Ftr, Ss^Ftm, Gll^Ftr, Gll^Ftr, Gll^Ftr, Gs^Ft, Gll^Ftr, Gll^Ftr, Gll^Ftr, Gll^Ftr
