Xue, Xue, Xue, Xue, Xue, Xue, Xue, Xue, Xue, Xue, Xue, Xue, Xue, Xue, Xue, Xue, Xue, Xue, Xue, Xue, Xue, Xue, Xue, Xue, Xue, Xue, Xue, Xue, Xue, Xue, Xue, Xue, Xue, Xue, Xue, Xue, Xue, Xue, Xue, Xue, Xue, Xue, Xue, Xue, Xue, Xue, Xue, Xue, Xue, Xue, Xue, Xue, Xue, Xue, Xue, Xue, Xue
Xue, Xue, Xue, Xue, Xue, Xue, Xue, Xue, Xue, Xue, Xue, Xue, Xue, Xue, Xue, Xue, Xue, Xue, Xue, Xue, Xue, Xue, Xue, Xue, Xue, Xue, Xue, Xue, Xue, Xue, Xue, Xue, Xue, Xue, Xue, Xue, Xue, Xue, Xue, Xue, Xue, Xue, Xue, Xue, Xue, Xue, Xue, Xue, Xue, Xue, Xue, Xue, Xue, Xue, Xue, Xue, Xue
Xue, Xue, Xue, Xue, Xue, Xue, Xue, Xue, Xue, Xue, Xue, Xue, Xue, Xue, Xue, Xue, Xue, Xue, Xue, Xue, Xue, Xue, Xue, Xue, Xue, Xue, Xue, Xue, Xoi, Xoi, Xoi, Xue, Xue, Xue, Xue, Xue, Xue, Xue, Xue, Xue, Xue, Xue, Xue, Xue, Xue, Xue, Xue, Xue, Xue, Xue, Xue, Xue, Xue, Xue, Xue, Xue, Xue
Xue, Xoi, Xue, Xue, Xue, Xue, Xue, Xue, Xue, Xue, Xue, Xoi, Xue, Xue, Xue, Xue, Xue, Xue, Xue, Xue, Xue, Xue, Xue, Xue, Xue, Xue, Xue, Xoi, Re, Re, Uue, Xoi, Xue, Xue, Xue, Xue, Xue, Xue, Xue, Xue, Xue, Xue, Xue, Xue, Xue, Xue, Xue, Xue, Xue, Xue, Xue, Xue, Xue, Xue, Xue, Xue, Xue
Xue, Xue, Xue, Xue, Xue, Xue, Xue, Xue, Xue, Xue, Xue, Xue, Xoi, Xue, Xoi, Xue, Xue, Xue, Xoi, Xoi, Xoi, Xue, Xue, Xue, Xoi, Xoi, Xoi, Xoi, Uue, Kdr, Uue^Vu, Xoi, Xoi, Xue, Xoi, Xoi, Xoi, Xue, Xoi, Xue, Xoi, Xue, Xoi, Xoi, Xoi, Xue, Xue, Xue, Xue, Xue, Xue, Xue, Xue, Xue, Xue, Xue, Xue
Xue, Xue, Xue, Xue, Xue, Xue, Xoi, Xue, Gll^Ftr, Gs^Ft, Dd^Ftd, Xoi, Cdr, Uue^Vu, Uue, Xoi, Cdr, Xoi, Wwf, Re, Cdr, Xoi, Re, Cdr^Iif, Uue^Vu, Uue, Re, Cdr, Re, Uue, Uue, Cdr, Re, Uue, Uhe, Cdr, Ds^Iif, Dd^Ftd, Gs^Ft, Xoi, Re, Uhe, Cdr, Xoi, Uhe, Xoi, Xoi, Xue, Uhe, Xue, Cdr, Xue, Xue, Xue, Xue, Xue, Xue
Xue, Xue, Xue, Xue, Gll^Ftr, Gll^Ftr, Gll^Ftr, Xoi, Gll^Ftr, Gs^Ft, Ds, Re^Iif, Uue, Cdr, Wwf, Uhe, Wwf, Wwf, Wwt, Wwf, Wwt, Re, Cdr, Re, Uhe, Cdr, Xoi, Uhe, Uue, Re, Uhe, Re, Re, Cdr, Uue, Re^Iif, Dd^Ftd, Gs^Ft, Gll^Ftr, Dd^Ftd, Ds^Iif, Uue^Vu, Re, Uue, Re, Uue, Re, Xoi, Re, Uue, Wwf, Wwf, Xue, Xue, Xue, Xue, Xue
Wwt, Xue, Xoi, Xue, Dd^Ftd, Gs^Ft, Dd^Ftd, Gs^Ft, Dd^Ftd, Gs^Ft, Xoi, Uue^Vu, Xue, Re, Wwt, Wwt, Xoi, Xoi, Wwf, Wwt, Wwf, Wwt, Wwt, Xoi, Xoi, Xoi, Xoi, Re, Uhe, Cdr, Re, Cdr, Xoi, Xoi, Xoi, Xoi, Gs^Ft, Gll^Ftr, Gll^Ftr, Gs^Ft, Xoi, Re, Xoi, Uhe, Uue, Cdr, Uue, Uue^Vu, Cdr, Kdr, Wwf, Re, Cdr, Xue, Xue, Xue, Xue
Wwt, Uue, Uue^Vu, Cdr^Iif, Uue^Iif, Ds^Iif, Uue^Iif, Ds^Iif, Cdr^Iif, Ds, Uue^Iif, Xoi, Xoi, Wwf, Wwt, Wwt, Wwf, Wwf, Dd^Ftd, Dd^Ftd, Gs^Ft, Dd^Ftd, Wwf^Iif, Wwt, Xue, Xue, Xue, Xoi, Uue, Re, Uue, Xoi, Xoi, Xue, Gs^Ft, Xue, Gll^Ftr, Gll^Ftr, Gs^Ft, Gs^Ft, Xue, Xoi, Uue, Uue^Vu, Re, Uhe, Cdr, Re, Uue, Cdr, Uue, Wwf, Xoi, Xue, Xue, Xue, Xue
Wwt, Re, Uhe, Uue, Cdr, Uue, Cdr, Kdr, Re, Uue^Iif, Wwt, Uue, Wwt, Wwt, Wwf, Wwt, Xue, Ds^Iif, Gs^Ft, Gll^Ftr, Gll^Ftr, Gll^Ftr, Dd^Ftd, Wwf, Wwf, Xoi, Wwf, Xoi, Re, Ds, Uhe^Iif, Xoi, Xoi, Gs^Ft, Gll^Ftr, Gll^Ftr, Dd^Ftd, Gs^Ft, Dd^Ftd, Xue, Xue, Xue, Xue, Re, Xue, Uue, Re, Uhe, Cdr, Uhe, Re, Wwf, Wwt, Xoi, Xoi, Xue, Xue
Wwt, Wwt, Xoi, Re, Uue, Re, Uhe, Cdr, Re, Wwf, Cdr, Wwt, Uhe, Wwf, Xue, Xue, Xoi, Uue^Vu, Dd^Ftd, Gll^Ftr, Dd^Ftd, Gs^Ft, Ds^Iif, Wwf, Uue, Wwf, Ds, Ds^Iif, Ds^Iif, Cdr, Dd^Ftd, Xoi, Xue, Xue, Dd^Ftd, Gs^Ft, Ds^Iif, Ds^Iif, Ds^Iif, Cdr^Iif, Xue, Xue, Xue, Xue, Xue, Xue, Xoi, Uue, Re, Uue, Wwf, Wwt, Wwt, Wwt, Xoi, Xue, Xue
Qxe, Wwt, Wwt, Cdr, Wwt, Wwt, Xoi, Wwf, Wwf, Wwf, Uue, Re, Uue, Uue, Xoi, Xue, Xue, Xoi, Xoi, Ds^Iif, Re, Cdr^Iif, Uue, Uhe, Uue^Vu, Re, Kdr^Iif, Ds^Iif, Cdr^Iif, Ds^Iif, Cdr^Iif, Gs^Ft, Xoi, Xue, Xue, Ds^Iif, Wwt, Wwf, Wwt, Wwt, Wwt, Xue, Wwf, Xue, Wwf, Xue, Xue, Xoi, Xoi, Wwf, Wwt, Wwt, Xoi, Xoi, Xue, Xue, Xue
Qxe, Wwt, Wwt, Wwt^Bh|, Xoi, Xoi, Wwt, Wwt, Wwt, Cdr, Uue^Iif, Uue^Vu, Xoi, Xoi, Xue, Xue, Xue, Xue, Xue, Xue, Xoi, Xoi, Xoi, Re, Xue, Xoi, Gs^Ft, Ds^Iif, Cdr^Iif, Kdr^Iif, Ds^Iif, Cdr^Iif, Xoi, Xue, Wwf, Wwf, Wwt, Wwt, Wwf, Wwt, Re, Wwf, Uue, Wwf, Cdr, Wwf, Wwf^Iif, Wwf, Wwt^Iif, Wwt^Iif, Wwf^Iif, Wwt^Iif, Gs^Ft, Dd^Ftd, Dd^Ftd, Xoi, Xue
Qxe, Qxe, Wwt, Cdr, Uue, Uue, Wwt, Wwt, Wwt, Cdr, Ds^Iif, Ds^Iif, Gs^Ft, Dd^Ftd, Gs^Ft, Dd^Ftd, Xue, Xue, Xue, Xue, Xoi, Xoi, Xoi, Xoi, Xue, Xoi, Gll^Ftr, Cdr^Iif, Dd^Ftd, Ds^Iif, Ds^Iif, Cdr^Iif, Ds^Iif, Xoi, Wwf, Wwt, Xue, Xue, Xue, Xoi, Xoi, Uue^Vu, Cdr, Uhe, Uhe, Uhe^Iif, Gs^Ft, Wwf^Iif, Wwf^Iif, Wwf^Iif, Ds^Iif, Ds^Iif, Gs^Ft, Gll^Ftr, Xoi, Xoi, Xue
Qxe, Qxe, Wwt, Wwt, Cdr, Wwt, Wwt, Wwt, Wwt^Iif, Wwt^Iif, Dd^Ftd, Gs^Ft, Gll^Ftr, Gll^Ftr, Gll^Ftr, Gs^Ft, Gs^Ft, Xue, Xoi, Xue, Uhe, Uue^Vu, Re, Xoi, Xue, Xoi, Xoi, Gs^Ft, Ds^Iif, Cdr^Iif, Uue, Ds^Iif, Uhe, Wwf, Uue, Re, Xue, Xue, Uue, Cdr, Re, Re, Kdr, Cdr, Uue^Iif, Dd^Ftd, Gs^Ft, Dd^Ftd, Wwf^Iif, Wwf^Iif, Wwf^Iif, Dd^Ftd, Dd^Ftd, Gll^Ftr, Gll^Ftr, Dd^Ftd, Xue
Qxe, Wwt, Wwt, Wwt, Wwt^Bh|, Xoi, Xoi, Wwt^Iif, Wwt^Iif, Wwf^Iif, Gs^Ft, Gll^Ftr, Gll^Ftr, Gll^Ftr, Gll^Ftr, Gll^Ftr, Gs^Ft, Xoi, Cdr, Re, Re, Cdr, Re, Uue, Cdr, Cdr, Xue, Xoi, Uue^Vu, Re, Re, Xoi, Xue, Uue^Vu, Xue, Xue, Xoi, Xoi, Re, Uhe, Cdr, Uue, Xue, Xue, Xoi, Cdr^Iif, Gs^Ft, Dd^Ftd, Ds^Iif, Wwf^Iif, Ds^Iif, Wwf^Iif, Gs^Ft, Gll^Ftr, Gll^Ftr, Gs^Ft, Xue
Wwt, Wwt, Uue, Uue, Cdr, Wwf^Iif, Wwt^Iif, Wwt^Iif, Kdr^Iif, Wwt^Bh/, Wwf^Iif, Gll^Ftr, Gll^Ftr, Gll^Ftr, Gs^Ft, Gll^Ftr, Ds^Iif, Ds^Iif, Uue, Uue, Wwf, Wwf, Wwf, Re, Uue, Uue, Re, Xue, Xue, Uhe, Uue, Uue, Xue, Xue, Xoi, Xoi, Uue^Vu, Re, Cdr, Uhe, Uue, Re, Xue, Xue, Xue, Xoi, Xoi, Gs^Ft, Dd^Ftd, Wwf^Iif, Wwf^Iif, Wwf^Iif, Gs^Ft, Gll^Ftr, Gll^Ftr, Dd^Ftd, Xue
Wwt, Wwt, Re, Uue^Vu, Gs^Ft, Dd^Ftd, Gs^Ft, Wwt^Bh/, Wwf^Iif, Wwt^Iif, Xoi, Gs^Ft, Xoi, Dd^Ftd, Wwt^Iif, Dd^Ftd, Wwt^Iif, Uue^Iif, Wwt, Cdr, Wwt, Wwt, Wwt, Wwf, Xoi, Xoi, Re, Xue, Xue, Re, Uhe, Cdr, Xue, Xue, Xue, Xoi, Uue, Uhe, Uhe, Re, Uhe, Re, Uue, Xue, Xue, Xue, Xue, Ds^Iif, Ds^Iif, Wwf^Iif, Wwf^Iif, Ds^Iif, Xue, Gll^Ftr, Dd^Ftd, Xue, Xue
Wwt, Uue, Uue, Ds^Iif, Gll^Ftr, Gll^Ftr, Gll^Ftr, Gs^Ft, Dd^Ftd, Wwt^Iif, Wwt^Iif, Xoi, Wwt^Iif, Wwt^Iif, Wwt, Wwt^Iif, Wwt, Wwt, Wwt, Wwt^Bh|, Uue^Vu, Wwt, Wwt, Wwt, Wwt, Uue, Uhe, Uhe, Cdr, Uue, Re, Cdr, Xoi, Xue, Xue, Xue, Xue, Xoi, Re, Uue, Cdr, Uhe, Re, Uue^Vu, Xue, Xue, Xue, Xue, Uue, Wwf^Iif, Wwt, Wwf^Iif, Xue, Xue, Xue, Xue, Xue
Xue, Uue, Xue, Dd^Ftd, Xue, Gll^Ftr, Gll^Ftr, Gll^Ftr, Gs^Ft, Wwf^Iif, Wwf^Iif, Wwt^Iif, Wwt, Wwt, Xoi, Uue, Wwt, Wwt, Wwt, Cdr, Xoi, Xoi, Wwt, Wwt, Wwt, Wwt, Uue, Re, Uue, Re, Uue, Xoi, Dd^Ftd, Ds^Iif, Ds^Iif, Xue, Xue, Xue, Xue, Uue, Re, Uue, Cdr, Uue, Uhe, Xue, Xue, Xue, Xue, Cdr, Wwf, Wwt, Xue, Xue, Xue, Xue, Xue
Xue, Xue, Xue, Xue, Xue, Dd^Ftd, Xue, Gll^Ftr, Gll^Ftr, Gs^Ft, Ds^Iif, Wwt^Iif, Wwt, Wwt, Wwf, Xoi, Wwt, Wwt, Wwt, Uue, Cdr, Uue, Wwt, Wwt, Wwt^Bh/, Cdr, Wwt, Wwf, Wwf, Uue^Vu, Ds^Iif, Ds^Iif, Gll^Ftr, Gs^Ft, Xoi, Xoi, Cdr, Xue, Xoi, Cdr, Uue, Cdr, Kdr, Uue, Cdr, Uue, Xue, Xue, Xue, Uue, Wwf, Wwf, Uue, Uue^Vu, Xue, Xue, Xue
Xue, Xue, Xue, Xue, Xue, Xoi, Xue, Gll^Ftr, Gll^Ftr, Dd^Ftd, Wwf, Wwf, Xoi, Wwt, Uue, Wwt, Uue, Wwt, Wwt, Wwt, Wwt, Wwt^Bh\, Kdr, Wwt^Bh/, Wwt, Wwt, Wwt, Wwt, Wwt, Re, Dd^Ftd, Gll^Ftr, Gll^Ftr, Dd^Ftd, Re^Iif, Cdr, Uue, Cdr, Re, Uhe, Uue, Cdr, Uue, Cdr, Uue, Uue, Uue, Cdr, Wwf, Wwf, Wwf, Xoi, Xoi, Uue, Uue, Xue, Uue
Xue, Xue, Xue, Xue, Xue, Xue, Xue, Dd^Ftd, Ds^Iif, Wwf, Uue^Vu, Cdr, Cdr, Re, Uhe, Cdr, Wwf, Cdr, Wwf, Wwt, Xoi, Uue, Re, Wwt, Wwt, Wwt, Wwt, Wwt, Wwt, Wwf^Iif, Ds^Iif, Gs^Ft, Dd^Ftd, Ds^Iif, Wwf, Uue, Wwf, Cdr, Wwf, Uue, Cdr, Uue, Uue, Uue, Uue, Uue^Vu, Wwt, Wwf, Wwt, Wwt, Wwt, Wwt, Wwt, Xoi, Wwt, Wwf, Wwt
Xue, Xue, Xue, Xue, Xue, Xue, Xue, Xue, Wwf, Wwt, Xoi, Cdr, Wwt, Uue, Uhe, Re, Re, Wwf, Uue^Vu, Uue, Cdr, Cdr, Re, Uue, Re, Wwt, Wwt, Wwt, Ds^Iif, Dd^Ftd, Gs^Ft, Ds^Iif, Wwf^Iif, Wwf^Iif, Wwt, Wwt, Wwt, Wwt^Bh|, Wwt, Wwt, Wwt, Wwf, Wwf, Re, Wwf, Re, Wwt, Wwt, Xoi, Wwf, Wwt, Wwt, Wwt, Wwt, Qxe, Wwt, Qxe
Xue, Xue, Xue, Xue, Xue, Xue, Xue, Xue, Wwf, Wwt, Xue, Xoi, Xoi, Xue, Xue, Uue, Cdr, Cdr, Re, Re, Uue, Re, Uue, Re, Uue, Cdr, Uue, Wwf, Dd^Ftd, Gs^Ft, Gll^Ftr, Ds^Iif, Wwf^Iif, Wwt, Wwt, Wwt, Wwt, Wwt^Bh|, Wwt, Wwt, Uue, Wwt, Cdr, Wwf, Re, Wwf, Uue, Wwt, Xue, Xoi, Wwf, Wwt, Wwt, Qxe, Wwt, Qxe, Qxe
Xue, Xue, Xue, Xue, Xoi, Xue, Re, Uue^Vu, Wwt, Wwt, Wwt, Xue, Xue, Xue, Xoi, Uue, Re, Kdr, Uue, Uhe, Xue, Xue, Cdr, Uue, Uhe, Re, Xoi, Ds^Iif, Gs^Ft, Gll^Ftr, Gll^Ftr, Dd^Ftd, Ds^Iif, Uue, Uue, Wwf, Re, Cdr, Re, Uue, Re, Uue^Vu, Cdr, Uue, Uhe, Re, Xue, Xue, Xue, Xue, Wwf, Wwt, Wwt, Wwt, Wwf, Wwt, Wwf
Xue, Xue, Xue, Xue, Xoi, Cdr, Uue, Wwf, Wwt, Wwt, Xoi, Xoi, Uue^Vu, Xue, Xue, Xoi, Xoi, Cdr, Re, Uue, Uue^Vu, Xue, Xue, Re, Uue^Vu, Uue, Uhe, Ds^Iif, Dd^Ftd, Gll^Ftr, Gll^Ftr, Gs^Ft, Ds^Iif, Re, Cdr, Re, Uue^Vu, Uue, Re, Uue, Cdr, Re, Uue, Re, Cdr, Cdr, Xue, Xue, Xoi, Re, Wwf, Wwt, Wwf, Wwf, Uue, Xoi, Xue
Xue, Xue, Xue, Xue, Uue, Re, Re, Wwt, Wwt, Wwt, Wwt, Re, Re, Xoi, Xoi, Xue, Xue, Xue, Re, Uue, Xue, Xue, Xue, Uue, Xoi, Re, Cdr, Kdr, Ds^Iif, Gs^Ft, Ds^Iif, Ds^Iif, Re, Uhe, Uue, Cdr, Re, Uue, Uhe, Xue, Xue, Xue, Xue, Uue, Xue, Xue, Xue, Xue, Xue, Xoi, Wwt, Wwf, Cdr, Cdr, Xue, Xue, Xue
Xue, Xue, Xue, Xue, Xue, Uue, Uue, Cdr, Wwt, Wwt, Wwt, Uue, Uue, Uue, Xoi, Xue, Xue, Xue, Uhe^Iif, Uhe, Uue, Xue, Xue, Xoi, Uue, Uue, Uue, Uue, Xue, Ds^Iif, Xue, Uue^Vu, Xoi, Xoi, Xue, Xue, Xue, Re, Cdr, Xue, Xoi, Xue, Xue, Xue, Xue, Xue, Xue, Xue, Xue, Uue, Wwt, Wwf, Re, Xue, Xue, Xue, Xue
Xue, Xue, Xue, Xue, Xoi, Xoi, Re, Cdr, Wwt^Bh\, Wwt, Wwt, Wwt, Cdr, Uue, Ds, Xue, Dd^Ftd, Dd^Ftd, Dd^Ftd, Re^Iif, Ds^Iif, Xoi, Xue, Xue, Xue, Xue, Xue, Xue, Xue, Xue, Xue, Xue, Xue, Xue, Xue, Xue, Xue, Cdr, Uue^Vu, Uue^Iif, Ds^Iif, Xoi, Xoi, Xue, Dd^Ftd, Ds^Iif, Ds^Iif, Xue, Xue, Wwt, Wwt, Uue, Uue^Vu, Xue, Xue, Xue, Xue
Xue, Xue, Xue, Xue, Xoi, Uhe, Re, Wwf, Wwt, Wwt^Bh\, Kdr, Wwt^Bh/, Wwt^Iif, Uue^Iif, Dd^Ftd, Dd^Ftd, Gll^Ftr, Gs^Ft, Gll^Ftr, Dd^Ftd, Dd^Ftd, Cdr^Iif, Xue, Xue, Xue, Xue, Xue, Xue, Xoi, Xoi, Cdr, Xue, Uue^Vu, Xoi, Xoi, Xue, Re, Uue, Re, Re^Iif, Dd^Ftd, Dd^Ftd, Gs^Ft, Gs^Ft, Gs^Ft, Gs^Ft, Gs^Ft, Dd^Ftd, Ds^Iif, Wwf^Iif, Wwf, Wwf, Xoi, Xue, Xue, Xue, Xue
Xue, Xue, Xue, Xue, Uue, Uue, Uue, Cdr, Cdr, Wwt^Bh/, Uue, Uue, Wwt^Iif, Ds, Gs^Ft, Gll^Ftr, Gll^Ftr, Gll^Ftr, Mdd^Iif, Gs^Ft, Dd^Ftd, Cdr^Iif, Xoi, Xue, Xue, Xue, Xoi, Uue, Uue^Vu, Uhe, Uue, Uue, Cdr, Uue, Uue, Xoi, Uue, Re, Ds, Ds^Iif, Gs^Ft, Gs^Ft, Gll^Ftr, Gll^Ftr, Cdr^Iif, Gll^Ftr, Gs^Ft, Dd^Ftd, Ds^Iif, Wwf^Iif, Wwf, Uue, Re, Xoi, Xue, Xue, Xue
Xue, Xue, Xue, Uue^Vu, Re, Uhe, Cdr, Kdr, Wwf, Wwt, Xoi, Xoi, Wwt^Iif, Dd^Ftd, Gll^Ftr, Gll^Ftr, Mdd^Iif, Mdd^Iif, Gll^Ftr, Gll^Ftr, Dd^Ftd, Re^Iif, Re, Xoi, Xoi, Wwt, Wwt^Bh/, Cdr, Re, Uue, Cdr, Re, Uue, Cdr, Uhe, Re, Cdr, Uue^Iif, Ds^Iif, Dd^Ftd, Xoi, Gs^Ft, Gll^Ftr, Gll^Ftr, Gll^Ftr, Gll^Ftr, Gs^Ft, Dd^Ftd, Xoi, Wwf^Iif, Wwf^Iif, Cdr, Cdr, Uue, Uue, Xoi, Xue
Xue, Xue, Xue, Xue, Xoi, Uue, Re, Cdr, Wwt, Wwt, Wwt, Wwt^Iif, Ds^Iif, Gs^Ft, Gll^Ftr, Gll^Ftr, Gll^Ftr, Gll^Ftr, Gll^Ftr, Gs^Ft, Uue, Cdr^Iif, Cdr, Uhe, Uhe, Cdr, Wwf, Wwt, Wwt^Bh/, Cdr, Re, Kdr, Cdr, Re, Uue, Uhe, Uue^Vu, Uue, Ds^Iif, Gs^Ft, Gll^Ftr, Gll^Ftr, Mdd^Iif, Mdd^Iif, Mdd^Iif, Gll^Ftr, Gll^Ftr, Gs^Ft, Ds^Iif, Xoi, Wwf^Iif, Wwf, Cdr, Kdr, Re, Xoi, Xue
Xue, Xue, Xue, Xue, Xue, Cdr, Uue, Xoi, Wwf, Wwt, Wwt, Wwt^Iif, Uue^Iif, Ds^Iif, Xoi, Gs^Ft, Dd^Ftd, Gs^Ft, Ds^Iif, Dd^Ftd, Xue, Uue, Uue, Uue, Re, Uue, Cdr, Wwt^Bh/, Wwt, Wwt, Wwt, Wwt, Wwt, Uue, Wwf, Re, Re, Ds^Iif, Ds^Iif, Gs^Ft, Gll^Ftr, Gll^Ftr, Gll^Ftr, Mdd^Iif, Gll^Ftr, Gll^Ftr, Gs^Ft, Dd^Ftd, Ds^Iif, Wwf^Iif, Wwf, Wwf, Uue, Uhe, Re, Uue, Xue
Xue, Xue, Xue, Xue, Xoi, Uue, Uhe, Re, Re, Wwt, Xoi, Wwt, Cdr, Uue^Iif, Xue, Dd^Ftd, Xoi, Dd^Ftd, Xue, Xue, Xue, Xue, Xue, Uue^Vu, Uue, Re, Uue, Re, Uue, Wwf, Uhe, Wwt, Wwt, Wwt, Wwt, Wwf, Uue, Uue^Iif, Ds^Iif, Gs^Ft, Gll^Ftr, Gll^Ftr, Cdr^Iif, Cdr^Iif, Xoi, Xoi, Dd^Ftd, Ds^Iif, Wwt^Iif, Wwf^Iif, Wwf, Ds, Xue, Xue, Xue, Xoi, Xue
Xue, Xue, Xue, Xue, Xoi, Uue, Xue, Uue, Re, Wwf, Wwt^Bh/, Wwt^Bh/, Wwt, Uue^Vu, Xue, Xue, Xue, Xoi, Xoi, Xue, Xue, Xue, Xoi, Xue, Uue, Uhe, Re, Re, Uue, Uue, Re, Uue^Vu, Re, Wwt, Wwt^Bh/, Cdr, Wwt, Wwf, Wwt^Iif, Ds^Iif, Gs^Ft, Gll^Ftr, Xoi, Gll^Ftr, Dd^Ftd, Dd^Ftd, Ds^Iif, Ds^Iif, Wwt^Iif, Wwf, Xoi, Wwf, Xue, Xue, Xoi, Xue, Xue
Xue, Xue, Xue, Xue, Xue, Xue, Xoi, Uue, Cdr, Kdr, Wwf, Wwt, Wwt, Wwt, Wwt, Xue, Cdr, Xoi, Cdr, Re, Uue, Xue, Re, Xoi, Re, Uue, Uue, Uhe, Kdr, Re, Cdr^Iif, Uue, Re, Cdr, Uue, Wwt, Wwt, Wwt, Wwt, Ds^Iif, Cdr^Iif, Xoi, Ds^Iif, Ds^Iif, Wwt^Iif, Ds^Iif, Wwt^Iif, Wwt^Iif, Wwt, Wwt, Wwt, Xoi, Xue, Xue, Xue, Xue, Xue
Xue, Xue, Xue, Xue, Xoi, Xoi, Ds^Iif, Re^Iif, Ds^Iif, Re^Iif, Re^Iif, Cdr, Uhe, Wwt, Wwt, Wwt, Wwt, Wwt, Wwt^Bh|, Wwt, Wwt, Re, Cdr, Uue, Re, Uue^Vu, Re, Cdr^Iif, Cdr^Iif, Ds^Iif, Cdr^Iif, Kdr, Re, Uhe, Uue^Vu, Re, Xue, Wwt, Xoi, Wwt^Iif, Wwt^Bh|, Wwt^Iif, Wwt, Wwt, Wwt, Wwt, Wwt, Wwt, Wwt^Iif, Wwt, Xoi, Xue, Xue, Xue, Xue, Xue, Xue
Xue, Xue, Xue, Xue, Xoi, Ds^Iif, Gs^Ft, Dd^Ftd, Gs^Ft, Dd^Ftd, Dd^Ftd, Cdr^Iif, Ds^Iif, Re, Xoi, Xoi, Re, Wwt, Cdr, Wwt, Wwt, Wwt, Cdr, Uue, Uhe, Re, Kdr, Ds^Iif, Cdr^Iif, Kdr^Iif, Cdr^Iif, Ds^Iif, Uue, Uhe, Re, Xue, Xue, Xue, Xue, Xoi, Cdr, Wwt, Wwt, Wwt, Ds^Iif, Wwt^Iif, Ds^Iif, Ds^Iif, Dd^Ftd, Ds^Iif, Xoi, Xue, Xue, Xue, Xue, Xue, Xue
Xue, Xue, Xue, Xue, Xoi, Dd^Ftd, Gs^Ft, Gll^Ftr, Gll^Ftr, Gs^Ft, Cdr^Iif, Dd^Ftd, Dd^Ftd, Ds^Iif, Dd^Ftd, Re, Ds^Iif, Re, Uue^Iif, Wwt^Bh\, Cdr, Wwt^Bh/, Uue, Re, Uue, Re, Re, Cdr^Iif, Cdr^Iif, Re^Iif, Ds^Iif, Cdr^Iif, Uhe, Uue, Uue, Xue, Xoi, Xue, Xoi, Xue, Wwt, Wwt, Wwt^Iif, Ds^Iif, Dd^Ftd, Dd^Ftd, Gs^Ft, Gs^Ft, Gs^Ft, Gs^Ft, Xue, Xue, Xue, Xue, Xue, Xue, Xue
Xue, Xue, Xue, Xue, Xoi, Ds^Iif, Dd^Ftd, Gll^Ftr, Gll^Ftr, Gll^Ftr, Gll^Ftr, Gs^Ft, Gll^Ftr, Gs^Ft, Gs^Ft, Dd^Ftd, Gs^Ft, Dd^Ftd, Ds^Iif, Uhe, Xoi, Xoi, Re, Xoi, Uhe, Xoi, Re, Re, Cdr, Kdr, Uue^Vu, Cdr, Re, Uue, Wwf, Xoi, Wwf, Xoi, Wwf, Wwf, Wwt, Wwt^Iif, Ds^Iif, Dd^Ftd, Gs^Ft, Gs^Ft, Gll^Ftr, Gll^Ftr, Gll^Ftr, Gs^Ft, Xue, Xue, Xue, Xue, Xue, Xue, Xue
Xue, Xue, Xue, Xue, Xue, Xue, Ds^Iif, Gs^Ft, Gll^Ftr, Cdr, Cdr^Iif, Kdr, Cdr, Gll^Ftr, Gll^Ftr, Gll^Ftr, Gll^Ftr, Gll^Ftr, Xoi, Ds^Iif, Re, Uue, Uue, Uue, Uhe, Uue, Uhe, Uue, Re, Re, Wwf, Wwf, Wwt, Wwt, Wwt, Wwt, Wwt, Wwt, Wwt, Wwt, Wwt^Iif, Ds^Iif, Dd^Ftd, Gs^Ft, Gll^Ftr, Gll^Ftr, Gll^Ftr, Gll^Ftr, Gs^Ft, Xoi, Xue, Xue, Xue, Xue, Xue, Xue, Xue
Xue, Xue, Xue, Xue, Xue, Xoi, Xoi, Xue, Dd^Ftd, Gs^Ft, Gs^Ft, Gll^Ftr, Gll^Ftr, Gll^Ftr, Gll^Ftr, Gll^Ftr, Gll^Ftr, Xoi, Gs^Ft, Ds^Iif, Re^Iif, Re, Re, Uue^Vu, Wwf, Wwf, Wwt, Wwf, Wwt, Wwt, Wwt, Wwt, Wwt, Wwt, Wwt, Wwt, Wwt, Wwt, Re, Wwt, Ds^Iif, Ds^Iif, Gs^Ft, Gs^Ft, Gs^Ft, Gll^Ftr, Xoi, Gs^Ft, Xue, Xue, Xue, Xue, Xue, Xue, Xue, Xue, Xue
Xue, Xue, Xue, Xue, Xue, Xue, Xue, Xue, Xoi, Ds^Iif, Ds^Iif, Dd^Ftd, Dd^Ftd, Gs^Ft, Xoi, Gll^Ftr, Gs^Ft, Gll^Ftr, Ds^Iif, Ds^Iif, Xoi, Xoi, Xoi, Xoi, Xoi, Xoi, Xoi, Wwt, Wwf, Wwt, Re, Wwf, Urb, Re, Xoi, Xoi, Xoi, Xoi, Xoi, Xoi, Xoi, Dd^Ftd, Xue, Xue, Xue, Xoi, Xue, Xue, Xue, Xue, Xue, Xue, Xue, Xue, Xue, Xue, Xue
Xue, Xue, Xue, Xue, Xue, Xue, Xue, Xue, Xue, Xoi, Xoi, Cdr^Iif, Ds^Iif, Ds^Iif, Ds^Iif, Ds^Iif, Cdr^Iif, Ds^Iif, Xue, Xue, Xue, Xue, Xue, Xue, Xue, Xue, Xoi, Re, Urb, Urb, Urb, Urb, Urb, Urb, Xoi, Xue, Xue, Xue, Xue, Xue, Xue, Xue, Xue, Xue, Xue, Xue, Xue, Xue, Xue, Xue, Xue, Xue, Xue, Xue, Xue, Xue, Xue
Xue, Xue, Xue, Xue, Xue, Xue, Xue, Xue, Xue, Xue, Xue, Xoi, Xue, Xue, Xue, Xue, Xue, Xue, Xue, Xue, Xue, Xue, Xue, Xue, Xue, Xue, Re, Urb, Urb, Urb, Urb, Urb, Urb, Xue, Xue, Xue, Xue, Xue, Xue, Xue, Xue, Xue, Xue, Xue, Xue, Xue, Xue, Xue, Xue, Xue, Xue, Xue, Xue, Xue, Xue, Xue, Xue
Xue, Xue, Xue, Xue, Xue, Xue, Xue, Xue, Xue, Xue, Xue, Xue, Xue, Xue, Xue, Xue, Xue, Xue, Xue, Xue, Xue, Xue, Xue, Xue, Xue, Xue, Urb, Urb, Urb, Urb, Urb, Urb, Urb, Xue, Xue, Xue, Xue, Xue, Xue, Xue, Xue, Xue, Xue, Xue, Xue, Xue, Xue, Xue, Xue, Xue, Xue, Xue, Xue, Xue, Xue, Xue, Xue
Xue, Xue, Xue, Xue, Xue, Xue, Xue, Xue, Xue, Xue, Xue, Xue, Xue, Xue, Xue, Xue, Xue, Xue, Xue, Xue, Xue, Xue, Xue, Xue, Xue, Xue, Xue, Xue, Xue, Urb, Xue, Urb, Xue, Xue, Xue, Xue, Xue, Xue, Xue, Xue, Xue, Xue, Xue, Xue, Xue, Xue, Xue, Xue, Xue, Xue, Xue, Xue, Xue, Xue, Xue, Xue, Xue
Xue, Xue, Xue, Xue, Xue, Xue, Xue, Xue, Xue, Xue, Xue, Xue, Xue, Xue, Xue, Xue, Xue, Xue, Xue, Xue, Xue, Xue, Xue, Xue, Xue, Xue, Xue, Xue, Xue, Xue, Xue, Xue, Xue, Xue, Xue, Xue, Xue, Xue, Xue, Xue, Xue, Xue, Xue, Xue, Xue, Xue, Xue, Xue, Xue, Xue, Xue, Xue, Xue, Xue, Xue, Xue, Xue
