Gll^Ftr, Gll^Ftr, Mdd, Gll^Ftr, Gs^Ftp, Gll^Ftr, Gs^Ft, Gg^Efm, Gg^Efm, Ss^Ftm, Gll^Ftr, Ss^Ftm, Gs^Ftp, Gg^Efm, Ss^Ftm, Ss^Ftm, Gg^Efm, Ss^Ftm, Gg^Efm, Ss^Ftm, Gg^Efm, Gs^Ft, Gg^Efm, Gg
Mdd, Mdd, Gll^Ftr, Gll^Ftr, Gs^Ft, Gg^Efm, Gg^Efm, Gg^Efm, Gs^Ft, Gll^Ftr, Gll^Ftr, Ss^Ftm, Ss^Ftm, Ss^Ftm, Gg^Efm, Gs^Ftp, Gs^Ft, Gs^Ft, Gll^Ftr, Gs^Ft, Gs^Ft, Ss^Ftm, Gs^Ft, Gg^Efm
Gs^Ft, Gll^Ftr, Gs^Ft, Gll^Ftr, Gs^Ftp, Gg^Efm, Gs^Ftp, Gs^Ftp, Gll^Ftr, Gll^Ftr, Mdd, Mdd, Gll^Ftr, Gs^Ft, Gg^Efm, Gg^Efm, Gll^Ftr, Qxe, Qxe, Gg^Efm, Gg^Efm, Gs^Ft, Gs^Ft, Gll^Ftr
Gs^Ft, Gg^Efm, Gll^Ftr, Gs^Ft, Gs^Ft, Gs^Ft, Ss^Ftm, Ss^Ftm, Qxe, Mdd, Qxe, Qxe, Qxe, Gll^Ftr, Gll^Ftr, Gs^Ft, Gll^Ftr, Qxe, Qxe, Gs^Ft, Gs^Ft, Gg^Efm, Gll^Ftr, Gll^Ftr
Gs^Ftp, Gg^Efm, Gs^Vc, Gs^Ecf, Gs^Ft, Gll^Ftr, Gll^Ftr, Gll^Ftr, Qxe, Qxe, Gs^Ft, Gs^Ft, Hh, Cdr, Kdr, Cdr, Cdr, Gll^Ftr, Gll^Ftr, Gll^Ftr, Qxe, Gll^Ftr, Gs^Ft, Gs^Ft
Gll^Ftr, Gs^Ft, Gg^Efm, Gs^Vc, Qxe, Gll^Ftr, Cdr, Qxe, Gs^Ft, Gs^Ftp, Hh, Mdd, Mdd, Hh, Gs^Ft, Gg, Hh, Gll^Ftr, Mdd, Gll^Ftr, Gll^Ftr, Qxe, Gg^Efm, Gg^Efm
Gll^Ftr, Gll^Ftr, Qxe, Gg^Efm, Gs^Ft, Cdr, Gg^Efm, Hh, Mdd, Mdd, Mdd, Hh, Qxe, Mdd, Qxe, Gs^Ftp, Mdd, Mdd, Gs^Ft, Gll^Ftr, Gg^Efm, Gs^Ft, Gll^Ftr, Gs^Ft
Gs^Ft, Gll^Ftr, Qxe, Gs^Ft, Gg^Efm, Gs^Ftp, Mdd, Gg^Efm, Gg^Efm, Mdd, Gs^Ftp, Gs^Ft, Gs^Ftp, Qxe, Qxe, Gg^Efm, Gg, Hh, Cdr, Gll^Ftr, Gg^Efm, Qxe, Qxe, Gll^Ftr
Gg^Efm, Gs^Ft, Gll^Ftr, Cdr, Gg^Efm, Mdd, Mdd, Mdd, Hh, Hh, Cdr, Cdr, Mdd, Hh, Hh, Gg^Efm, Gs^Ftp, Cdr, Kdr, Gs^Ft, Gg^Efm, Qxe, Qxe, Qxe
Gg^Efm, Gg^Efm, Gs^Ft, Kdr, Cdr, Hh, Qxe, Gs^Ftp, Mdd, Hh, Kdr, Kdr, Kdr, Cdr, Mdd, Gg^Efm, Gs^Ft, Cdr, Hh, Gg^Efm, Gs^Ft, Gs^Ft, Qxe, Qxe
Gll^Ftr, Qxe, Gll^Ftr, Cdr, Gs^Ft, Qxe, Qxe, Gs^Ft, Mdd, Cdr, Kdr, Km, Kdr, Cdr, Mdd, Gs^Ftp, Qxe, Gs^Ft, Gs^Ft, Cdr, Gll^Ftr, Gll^Ftr, Qxe, Gll^Ftr
Gll^Ftr, Gll^Ftr, Gll^Ftr, Gs^Ft, Mdd, Gs^Ft, Hh, Hh, Qxe, Mdd, Cdr, Kdr, Mdd, Cdr, Hh, Gs^Ftp, Qxe, Hh, Cdr, Cdr, Gll^Ftr, Qxe, Gll^Ftr, Gll^Ftr
Gll^Ftr, Qxe, Qxe, Mdd, Mdd, Mdd, Cdr, Qxe, Gs^Ft, Hh, Hh, Mdd, Qxe, Mdd, Qxe, Gg^Efm, Gg^Efm, Gs^Ftp, Gll^Ftr, Gll^Ftr, Gll^Ftr, Qxe, Gll^Ftr, Gs^Ft
Gll^Ftr, Gll^Ftr, Qxe, Gll^Ftr, Gll^Ftr, Gs^Ft, Gs^Ft, Gs^Ft, Mdd, Mdd, Mdd, Gs^Ft, Qxe, Gs^Ft, Gs^Ftp, Gg^Efm, Mdd, Mdd, Gll^Ftr, Ss^Ftm, Ss^Ftm, Ss^Ftm, Ss^Ftm, Gs^Ft
Gll^Ftr, Gll^Ftr, Gll^Ftr, Gll^Ftr, Ss, Gll^Ftr, Gll^Ftr, Cdr, Gll^Ftr, Mdd, Gll^Ftr, Gll^Ftr, Gll^Ftr, Cdr, Gll^Ftr, Mdd, Gll^Ftr, Gll^Ftr, Gll^Ftr, Ss^Ftm, Gll^Ftr, Ss^Ftm, Gll^Ftr, Ss^Ftm
