Xu, Xu, Xu, Xu, Xu, Xu, Xu, Xu, Xu, Xu, Xu, Xu, Xu, Xu, Xu, Xu, Xu, Xu, Xu, Uu, Wwf, Ww, Xu, Xu, Xu, Xuc, Xu, Xu, Xu, Xu, Xu, Xu, Xu, Xu, Xu, Xu, Xu
Xu, Xu, Xu, Xu, Xu, Xu, Xu, Xu, Uu, Xu, Uh, Xuc, Xuc, Xu, Xuc, Xu, Xu, Xu, Uh, Ur, Wwf, Ww, Uu, Xu, Xu, Xuc, Xu, Xu, Xu, Xu, Xu, Xu, Xu, Xu, Xu, Xu, Xu
Xu, Xu, Xu, Xu, Xu, Xuc, Uu, Tb^Tf, Ur, Uh, Uu, Tb^Tf, Uu, Ur, Uu, Xuc, Uh, Xu, Uu, Uu, Tb^Tf, Wwf, Ww, Xu, Xuc, Xu, Xu, Xu, Xu, Xu, Xuc, Xu, Xu, Xu, Xu, Xu, Xu
Xu, Xu, Xu, Xu, Xu, Uu^Vu, Ur, Uu, Uu, Uu, Uu, Ur, Cte, Cte, Kte, Ur, Ur, Uu, Uh, Uh, Uu, Ww, Ww, Uu^Vu, Uu, Xuc, Xu, Xu, Xu, Xuc, Uh, Uh, Uh, Xu, Xu, Xu, Xu
Xu, Xu, Xu, Xu, Tb^Tf, Uu, Wwf, Wwf, Wwf, Wwf, Wwf, Uu, Ur, Cte, Uh, Cte, Tb^Tf, Uu, Ur, Ur, Ww, Ww, Ur, Ur, Xuc, Uu, Uu, Tb^Tf, Ur, Uu, Cte, Uu, Uu, Xu, Uh, Xu, Xu
Xu, Xu, Xu, Xuc, Uu, Wwf, Ww, Ww, Ww, Wwf, Wwf, Ur, Wwf, Tb^Tf, Wwf, Ur, Wwf, Uu, Wwf, Ww, Wwf, Ww, Tb^Tf, Xu, Xu, Xuc, Uu, Uu, Uu, Cte, Tb^Tf, Kte, Uu^Vu, Uu, Ur, Uh, Uu
Xu, Xu, Xu, Xuc, Xuc, Ww, Wot, Wot, Wot, Ww, Wwf, Wwf, Uu, Wwf, Ur, Wwf, Ww, Wwf, Wwf, Wwf, Uu, Ur, Xu, Xu, Xu, Uu, Ur, Ur, Xu, Uu, Xu, Uu, Uu, Tb^Tf, Xu, Ur, Uu
Xu, Xu, Xu, Xu, Xu, Ww, Wot, Wot, Ww, Ww, Ur, Uu, Xu, Xu, Uu, Wwf, Ww, Ww, Xuc, Ur, Uh, Uu, Uu, Xuc, Xuc, Uu, Xuc, Uh, Uu, Xu, Xu, Xu, Xu, Xu, Xu, Xu, Xu
Xu, Xu, Xu, Xu, Uu, Ww, Wot, Wot, Ww, Wwf, Ur, Xuc, Xuc, Xu, Wwf, Ww, Ww, Xuc, Ur, Ur, Tb^Tf, Ur, Uu, Uh, Uh, Ur, Uu, Xuc, Uh, Uu, Xu, Xu, Xu, Xu, Xu, Xu, Xu
Xu, Xu, Xu, Xu, Tb^Tf, Ww, Ww, Wot, Ww, Ww, Tb^Tf, Xuc, Ur, Uu^Vu, Wwf, Ww, Tb^Tf, Uu, Xu, Xu, Uu, Ur, Uu, Xu, Uu^Vu, Uu, Xu, Uu, Xu, Tb^Tf, Uu, Xu, Xu, Xu, Xu, Xu, Xu
Xu, Xu, Xu, Xu, Xu, Tb^Tf, Ur, Ww, Wwf, Wwf, Wwf, Uu, Wwf, Wwf, Wwf, Uu, Xuc, Xu, Xu, Xu, Xuc, Uh, Ur, Tb^Tf, Ur, Uu, Uu, Xu, Cte, Ur, Ur, Xu, Xuc, Xu, Xu, Xu, Xu
Xu, Xu, Xu, Xu, Xu, Ur, Xu, Uu^Vu, Xu, Wwf, Wwf, Wwf, Tb^Tf, Wwf, Ur, Ur, Xu, Xu, Xu, Xu, Xu, Xuc, Xuc, Uu, Uu, Ur, Uh, Uu, Ur, Uu, Uu, Uh, Uu, Xuc, Xuc, Xu, Xu
Xu, Xu, Xu, Xu, Uh, Uh, Xu, Xu, Xu, Xu, Wwf, Uu, Uu, Ur, Xu, Xuc, Xu, Xu, Xu, Xu, Xu, Xu, Xu, Xuc, Xu, Xu, Xuc, Ur, Uu, Uu, Ur, Uh, Uu^Vu, Uh, Xu, Xu, Xu
Xu, Xu, Xu, Xu, Ur, Xuc, Xuc, Xuc, Xuc, Wwf, Tb^Tf, Ur, Uh, Uu^Vu, Xu, Xu, Xu, Xu, Xu, Xu, Xu, Xu, Xu, Xu, Xu, Xu, Uh, Uh, Xu, Xu, Xu, Tb^Tf, Ur, Uu, Xu, Xu, Xu
Xu, Xu, Xu, Xu, Xu, Uu, Xuc, Uu, Cte, Wwf, Wwf, Ur, Uh, Xu, Xu, Xu, Xu, Xu, Xu, Xu, Xuc, Xu, Xu, Xu, Xu, Xu, Xu, Uu, Uu, Xu, Xu, Xuc, Ur, Uh, Xuc, Xu, Xu
Xu, Xu, Xu, Xu, Xu, Tb^Tf, Uu^Vu, Ur, Xu, Xu, Wwf, Uu, Ur, Xuc, Xu, Xu, Xu, Xu, Uu^Vu, Uu, Uu, Uh, Xuc, Xuc, Xuc, Xu, Ur, Ur, Uu, Xu, Xu, Xu, Tb^Tf, Ur, Uu, Xu, Xu
Xu, Xu, Xu, Xu, Xu, Uh, Uh, Ur, Xu, Xu, Ww, Ww, Ur, Xuc, Xu, Xu, Xuc, Uh, Uu, Ur, Uu, Uu, Uu, Uu, Uu, Xu, Uu^Vu, Uu, Uh, Uu, Xu, Xu, Xuc, Cte, Uu, Xu, Xu
Xu, Xu, Xu, Xu, Xu, Xu, Ur, Xu, Xu, Xuc, Ww, Ww, Ww, Uu, Uu, Xu, Xuc, Uh, Uu, Cte, Kte, Cte, Uu, Ur, Tb^Tf, Ur, Uu, Uh, Xuc, Xu, Xu, Xu, Xu, Ur, Uh, Xu, Xu
Xu, Xu, Xu, Xu, Xu, Xu, Tb^Tf, Uu, Xu, Xuc, Xuc, Ww, Ww, Tb^Tf, Uu^Vu, Xu, Xuc, Xuc, Ur, Cte, Cte, Uu, Xu, Xu, Uu, Tb^Tf, Uh, Uh, Xu, Xu, Xu, Xu, Xuc, Uh, Xuc, Xu, Xu
Xu, Xu, Xu, Xu, Xuc, Uu, Ur, Xuc, Xu, Xu, Xuc, Ww, Wwf, Ur, Xuc, Ur, Tb^Tf, Ur, Uu, Uu, Uu, Ur, Ur, Tb^Tf, Uu, Uu, Xu, Xu, Xu, Xu, Xuc, Xu, Ur, Tb^Tf, Xu, Xu, Xu
Xu, Xu, Xu, Xu, Uu, Tb^Tf, Uh, Xu, Ur, Xu, Ur, Wwf, Wwf, Ur, Uh, Uu, Xu, Uu, Uh, Tb^Tf, Ur, Uu, Xuc, Uu, Xu, Xu, Xu, Xu, Uu^Vu, Tb^Tf, Ur, Uu, Uh, Uu, Xu, Xu, Xu
Uh, Xu, Xu, Xu, Uh, Cte, Ur, Uu, Tb^Tf, Uu^Vu, Uu, Wwf, Ww, Wwf, Tb^Tf, Xu, Xu, Xu, Uu, Ur, Uu, Xuc, Xu, Xu, Xu, Xu, Xu, Uh, Uu, Uu, Ur, Uh, Xuc, Xu, Xu, Xu, Xu
Ur, Ur, Uu, Uu, Cte, Kte, Uu, Uu, Uh, Xu, Xu, Xu, Ww, Ww, Uu, Xuc, Xu, Xu, Tb^Tf, Uh, Uu, Uh, Xu, Xu, Xu, Xu, Xu, Xuc, Ur, Uu, Kte, Tb^Tf, Uu, Xu, Uu, Xu, Xu
Uh, Uh, Uh, Uu, Uu, Uu, Ur, Uh, Xu, Xu, Xuc, Ww, Ww, Ur, Uu^Vu, Xuc, Xu, Xu, Xuc, Uh, Ur, Tb^Tf, Uu, Xu, Xu, Xu, Xu, Uh, Ur, Uu, Uu, Cte, Uu, Uu, Uu, Uh, Uu
Xu, Xu, Xu, Xu, Xuc, Tb^Tf, Ur, Xu, Xu, Xu, Xuc, Ww, Uu, Ur, Xu, Xu, Xu, Xu, Xu, Xuc, Uu, Ur, Uu, Xuc, Uh, Uu, Tb^Tf, Uu, Xu, Tb^Tf, Uu, Uu, Xu, Uh, Xu, Uu, Uu
Xu, Xu, Xu, Xu, Xu, Uu, Tb^Tf, Xu, Xu, Xu, Ww, Ww, Ur, Uu, Xuc, Xu, Xu, Xu, Xu, Xuc, Uh, Uu^Vu, Tb^Tf, Uu, Cte, Ur, Xuc, Xuc, Xu, Xu, Xuc, Ur, Xu, Xu, Xu, Xu, Xu
Xu, Xu, Xu, Xu, Xu, Uu, Cte, Xu, Xu, Xu, Ww, Ww, Uh, Uu, Ur, Xu, Xu, Xu, Uh, Xuc, Ur, Ur, Xu, Uu, Uh, Xuc, Xu, Xu, Xu, Xu, Xuc, Uh, Uh, Xu, Xu, Xu, Xu
Xu, Xu, Xu, Xu, Xuc, Uu, Ur, Xuc, Xuc, Xu, Xu, Wwf, Wwf, Wwf, Wwf, Ur, Uu, Uu, Ur, Uu, Xu, Uu, Xuc, Xu, Uh, Xuc, Xu, Xu, Xu, Xu, Xuc, Xuc, Uh, Xu, Xu, Xu, Xu
Xu, Xu, Xu, Xuc, Uu, Uu, Uh, Uh, Uu^Vu, Uu, Uu, Tb^Tf, Uu, Ur, Tb^Tf, Wwf, Wwf, Uu, Wwf, Wwf, Wwf, Wwf, Wwf, Ur, Uu, Ur, Uh, Xu, Xu, Xu, Tb^Tf, Uu^Vu, Ur, Xuc, Xu, Xu, Xu
Xu, Xu, Xu, Xu, Uh, Ur, Xu, Uh, Uu, Uu, Uu, Uu, Uh, Uu, Xuc, Uu, Ur, Wwf, Wwf, Wwf, Wwf, Wwf, Ww, Ww, Ww, Uh, Ur, Xu, Xu, Xu, Tb^Tf, Ur, Xu, Xuc, Xu, Xu, Xu
Xu, Xu, Xu, Xu, Uh, Ur, Uu, Cte, Xuc, Xuc, Xu, Xu, Xu, Xuc, Xu, Xu, Xuc, Uh, Ur, Uu, Ur, Ur, Uu, Ww, Ww, Uu^Vu, Uu, Xuc, Xu, Xu, Uu, Ur, Uu, Xuc, Uu, Xu, Uu
Xu, Xu, Xu, Xu, Xuc, Uu, Uu, Uh, Uu, Xu, Xu, Xu, Xu, Xu, Xu, Xuc, Tb^Tf, Uu, Uu, Uu^Vu, Tb^Tf, Xuc, Xuc, Wwf, Ww, Ww, Ur, Uu, Ur, Tb^Tf, Uu, Cte, Kte, Cte, Uu, Uu, Uu
Xu, Xu, Xu, Xu, Xu, Xuc, Ur, Ur, Tb^Tf, Xu, Xu, Xu, Xuc, Uh, Uu, Uu, Ur, Ur, Uh, Uh, Xu, Xu, Xu, Ur, Wwf, Ww, Tb^Tf, Uu, Uh, Uu, Ur, Uu, Tb^Tf, Uu, Uu, Tb^Tf, Xu
Xu, Xu, Xu, Xu, Xu, Xu, Xuc, Uu, Ur, Xuc, Xuc, Xu, Uu, Tb^Tf, Ur, Uu, Xu, Uu, Xu, Xu, Xu, Xu, Xue, Re, Wwf^Iif, Uue, Xue, Xu, Xu, Uu^Vu, Ur, Uu, Xuc, Xuc, Xu, Xu, Xu
Xu, Xu, Xu, Xu, Xu, Xu, Xuc, Uu^Vu, Ur, Uh, Uh, Uu, Uu^Vu, Ur, Uu, Xuc, Xue, Xu, Xu, Xu, Xue, Xue, Xue, Wwf^Iif, Wwf^Iif, Wwf^Iif, Uue^Iif, Xue, Xue, Xuc, Uue, Uh, Xue, Xu, Xu, Xu, Xu
Xu, Xu, Xu, Xu, Xu, Xu, Tb^Tf, Tb^Tf, Cte, Kte, Cte, Cte, Ur, Uh, Uue, Xue, Uhe^Iif, Xue, Xue, Xue, Xue, Xue, Ds^Iif, Uue^Iif, Ds^Iif, Ds^Iif, Ds^Iif, Xue, Xue, Xue, Re, Uhe, Uhe, Xue, Xu, Xu, Xu
Xu, Xu, Xuc, Xu, Xuc, Xu, Ur, Uu, Uh, Cte, Uu, Uu, Uh, Ur, Uue, Uue, Re^Iif, Uue^Iif, Ds^Iif, Ds^Iif, Gs^Ft, Gs^Ft, Gll^Ftr, Gs^Ft, Gll^Ftr, Gs^Ft, Gs^Ft, Xue, Uue^Iif, Uue^Iif, Uue^Iif, Uhe, Xue, Xue, Xu, Xu, Xu
Uu, Xuc, Uh, Uu, Ur, Uh, Uu, Uu, Tb^Tf, Uu, Ur, Tb^Tf, Xuc, Uu, Xu, Re^Iif, Uue^Iif, Ds^Iif, Gs^Ft, Gs^Ft, Gll^Ftr, Gll^Ftr, Ss^Ftm, Gll^Ftr, Gs^Ft, Gll^Ftr, Gll^Ftr, Ds^Iif, Uue^Iif, Re^Iif, Re^Iif, Xue, Xu, Xuc, Xu, Xu, Xu
Ur, Ur, Uu, Tb^Tf, Uu^Vu, Ur, Xu, Xuc, Xu, Xu, Xu, Xuc, Xu, Xu, Xu, Xue, Xu, Xue, Gs^Ft, Gll^Ftr, Gll^Ftr, Gs^Ft, Ss^Ftm, Ss^Ftm, Ss^Ftm, Gll^Ftr, Gll^Ftr, Gs^Ft, Xue, Xue, Xue, Xue, Xu, Xu, Xu, Xu, Xu
Xu, Uu, Xu, Xu, Xu, Xu, Xu, Xu, Xu, Xu, Xu, Xu, Xu, Xu, Xu, Xu, Xu, Xue, Xue, Gll^Ftr, Gll^Ftr, Gs^Ft, Gll^Ftr, Gs^Ft, Gll^Ftr, Gll^Ftr, Gs^Ft, Xue, Xu, Xu, Xu, Xu, Xu, Xu, Xu, Xu, Xu
Xu, Xu, Xu, Xu, Xu, Xu, Xu, Xu, Xu, Xu, Xu, Xu, Xu, Xu, Xu, Xu, Xu, Xu, Xue, Gs^Ft, Gs^Ft, Gll^Ftr, Gs^Ft, Gll^Ftr, Gs^Ft, Gll^Ftr, Xue, Xue, Xu, Xu, Xu, Xu, Xu, Xu, Xu, Xu, Xu
Xu, Xu, Xu, Xu, Xu, Xu, Xu, Xu, Xu, Xu, Xu, Xu, Xu, Xu, Xu, Xu, Xu, Xu, Xu, Xue, Xue, Xue, Xue, Xue, Xue, Xue, Xu, Xu, Xu, Xu, Xu, Xu, Xu, Xu, Xu, Xu, Xu
