Gll^Ftr, Mdd, Mdd, Gll^Ftr, Gll^Ftr, Gll^Ftr, Ss^Ftm, Gll^Ftr, Gll^Ftr, Gll^Ftr, Gs^Ft, Dd, Mdd, Mdd, Gs^Ft, Gs^Ft, Gd^Fts, Dd^Ftd, Mdd, Mdd, Mdd, Dd^Ftd, Gd^Fts, Gd^Fts, Gd^Fts, Gd, Gd^Fts, Mdd, Gd^Fts, Gd^Fts, Gd^Fts, Gd^Fts, Gs^Ft, Gs^Ft, Mdd, Gll^Ftr, Gll^Ftr, Gll^Ftr, Gs^Ft, Gg^Efm, Gs^Ft, Gll^Ftr, Gll^Ftr, Gll^Ftr
Gs^Ft, Gll^Ftr, Gs^Ft, Mdd, Gll^Ftr, Gll^Ftr, Cdr, Gll^Ftr, Gll^Ftr, Gs^Ft, Gs^Ft, Mdd, Mdd, Mdd, Gd^Fts, Gd^Fts, Gd^Fts, Gd^Fts, Gd^Fts, Mdd, Gd, Gd^Fts, Gd, Gs, Gs, Gd^Fts, Gd^Fts, Gd^Fts, Gs, Gd^Fts, Gd^Fts, Mdd, Gd^Fts, Mdd, Mdd, Mdd, Gs^Ft, Gll^Ftr, Ss^Ftm, Gg^Efm, Gs^Ft, Gll^Ftr, Gll^Ftr, Gll^Ftr
Gg^Efm, Gg^Efm, Gll^Ftr, Gll^Ftr, Mdd, Gll^Ftr, Gs^Ft, Gll^Ftr, Mdd, Mdd, Gd^Fts, Gd^Fts, Gs, Gd^Fts, Gd, Gd, Gd, Gd, Gd^Fts, Gd, Dd^Ftd, Gd^Fts, Gd, Gd^Fts, Gd, Gd, Gd, Gd, Gd, Gd, Gd^Fts, Gd^Fts, Gd^Fts, Gd^Fts, Mdd, Gs^Ft, Gs^Ft, Gll^Ftr, Cdr, Gll^Ftr, Mdd, Mdd, Mdd, Gll^Ftr
Gs^Ft, Gs^Ft, Gll^Ftr, Mdd, Mdd, Mdd, Gs^Ft, Mdd, Gd^Fts, Gd^Fts, Gd, Gd^Fts, Dd, Gd, Gd^Fts, Dd^Ftd, Dd^Edpp, Dd^Ftd, Dd^Ftd, Gd, Dd^Edpp, Gd, Dd^Ftd, Gd^Fts, Dd, Gd, Dd^Ftd, Gd^Fts, Gd, Gd^Fts, Gd, Gs, Gd, Mdd, Mdd, Mdd, Mdd, Gll^Ftr, Gs^Ft, Gll^Ftr, Gll^Ftr, Mdd, Gll^Ftr, Gll^Ftr
Gll^Ftr, Gll^Ftr, Mdd, Gs^Ft, Gs^Ft, Gd^Fts, Gs, Gd^Fts, Gs, Gd, Dd, Gd, Dd^Ftd, Gd, Gd, Dd^Edpp, Dd, Gd, Dd^Edpp, Dd, Dd, Dd^Edpp, Gd, Dd, Dd^Ftd, Gd, Dd, Gd, Dd, Gd, Gd^Fts, Gd, Gd^Fts, Gd^Fts, Gd^Fts, Mdd, Mdd, Mdd, Gs^Ft, Gs^Ft, Gs^Ft, Gs^Ft, Gg^Efm, Gs^Ft
Gll^Ftr, Mdd, Mdd, Mdd, Gd^Fts, Gd^Fts, Gd^Fts, Gd, Dd, Gd, Gd, Dd, Dd, Dd^Ftd, Dd^Edpp, Gd, Dd, Dd^Edpp, Hhd, Dd, Hhd, Dd^Edpp, Hhd, Dd, Dd^Edpp, Dd, Dd, Gd^Edpp, Dd^Ftd, Gd, Gd, Gd, Gd, Gs, Gs, Gd^Fts, Gd^Fts, Gd^Fts, Gd^Fts, Gs^Ft, Mdd, Gll^Ftr, Gs^Ft, Gg^Efm
Gll^Ftr, Gs^Ft, Gs^Ft, Gd^Fts, Gs, Gd, Gs, Dd, Gd^Fts, Gd, Dd, Gd, Dd, Dd^Edpp, Dd^Edpp, Hhd, Hhd, Dd, Hhd, Hhd, Dd, Dd, Hhd, Dd, Dd, Hhd, Dd^Edpp, Dd^Edpp, Dd, Dd, Dd^Ftd, Gd^Fts, Gd, Gd^Fts, Gd^Fts, Gd^Fts, Gs, Gd^Fts, Gd^Fts, Mdd, Mdd, Mdd, Gll^Ftr, Gs^Ft
Gll^Ftr, Gs^Ft, Mdd, Gd^Fts, Gd^Fts, Gd, Gd^Fts, Gd, Dd, Gd, Dd, Dd^Ftd, Hhd, Hhd, Dd, Dd, Hhd, Dd, Hhd, Hhd, Hhd, Hhd, Hhd, Dd, Hhd, Hhd, Dd, Hhd, Dd^Edpp, Dd, Gd, Gd, Dd, Gd, Gd, Gd, Gd^Fts, Gs, Gd^Fts, Gs^Ft, Gs^Ft, Gll^Ftr, Gll^Ftr, Gg
Gll^Ftr, Mdd, Mdd, Mdd, Gd^Fts, Gd^Fts, Dd, Dd, Dd^Ftd, Gd, Dd, Dd^Edpp, Dd, Hhd, Hhd, Hhd, Hhd, Hhd, Md, Hhd, Md, Hhd, Hhd, Hhd, Hhd, Hhd, Hhd, Hhd, Hhd, Dd^Ftd, Dd, Dd, Dd^Ftd, Gd, Gd, Gd^Fts, Gd, Gd^Fts, Mdd, Gs^Ft, Gs^Ft, Gll^Ftr, Mdd, Gll^Ftr
Gll^Ftr, Gs^Ft, Gs^Ft, Gd^Fts, Gs, Gs, Gd, Gd, Dd, Dd^Edpp, Dd^Edpp, Dd, Hhd, Hhd, Hhd, Hhd, Md, Md, Md, Md, Md, Md, Md, Hhd, Hhd, Hhd, Hhd, Dd, Dd, Dd^Edpp, Dd, Dd^Ftd, Dd, Gd, Gd, Gd, Gd, Gd^Fts, Gd^Fts, Mdd, Mdd, Mdd, Mdd, Mdd
Gll^Ftr, Mdd, Mdd, Gd^Fts, Gd^Fts, Gd, Dd, Dd, Gd, Dd, Dd, Dd, Dd, Hhd, Hhd, Md, Md, Md, Uu, Hhd, Uu, Md, Hhd, Md, Md, Hhd, Hhd, Dd, Hhd, Dd^Edpp, Gd, Gd, Gd, Gd, Gd^Fts, Gd^Fts, Gd, Gs, Gd^Fts, Gd^Fts, Gd^Fts, Gd^Fts, Gs^Ft, Hd
Gll^Ftr, Gll^Ftr, Gs^Ft, Mdd, Gd^Fts, Gd^Fts, Gd, Dd, Dd^Ftd, Dd^Edpp, Dd, Hhd, Hhd, Hhd, Md, Mv, Md, Hhd, Qlf, Qlf, Qlf, Uu, Uu, Md, Md, Md, Hhd, Hhd, Dd, Dd, Dd^Edpp, Dd, Dd^Ftd, Gd, Gd, Gd, Gd, Gd^Fts, Gd^Fts, Gd^Fts, Mdd, Gs^Ft, Gs^Ft, Gs^Ft
Gll^Ftr, Gll^Ftr, Dd^Ftd, Gd^Fts, Gs, Gd^Fts, Gd, Dd, Dd, Dd, Hhd, Dd, Hhd, Hhd, Md, Md, Md, Uu, Uu, Qlf, Qlf, Uu, Hhd, Hhd, Md, Mv, Md, Hhd, Hhd, Dd^Edpp, Dd, Dd^Ftd, Dd, Dd, Gd, Gd^Fts, Gd^Fts, Gd^Fts, Gs, Gd^Fts, Gd^Fts, Mdd, Mdd, Gll^Ftr
Mdd, Gs^Ft, Gd^Fts, Gd^Fts, Gd, Gs, Dd, Gd, Dd^Ftd, Dd, Dd^Edpp, Hhd, Dd, Hhd, Hhd, Md, Md, Hhd, Mv, Uu, Hhd, Uu, Md, Md, Hhd, Md, Hhd, Hhd, Dd, Hhd, Dd, Gd, Gd, Gd, Gd, Gd, Gd, Gs, Gd^Fts, Gd^Fts, Mdd, Gs^Ft, Gll^Ftr, Gll^Ftr
Gll^Ftr, Mdd, Mdd, Gd^Fts, Gs, Gd^Fts, Gd, Dd, Dd, Dd^Ftd, Dd^Edpp, Dd, Hhd, Hhd, Hhd, Hhd, Hhd, Md, Md, Md, Md, Md, Md, Md, Hhd, Hhd, Hhd, Dd, Dd^Edpp, Dd^Edpp, Dd^Ftd, Gd, Dd, Gd, Gd, Gd^Fts, Gd^Fts, Gd^Fts, Mdd, Mdd, Gll^Ftr, Gll^Ftr, Gg, Gll^Ftr
Gll^Ftr, Gll^Ftr, Mdd, Gs^Ft, Gd^Fts, Gd, Gd^Fts, Dd, Gd, Gd, Dd, Hhd, Hhd, Dd, Dd, Hhd, Hhd, Hhd, Hhd, Md, Md, Md, Hhd, Hhd, Hhd, Hhd, Dd, Hhd, Dd, Dd^Edpp, Gd, Dd, Dd, Gd, Gd^Fts, Gs, Gs, Gd^Fts, Gs^Ft, Gs^Ft, Gll^Ftr, Gll^Ftr, Mdd, Gll^Ftr
Gll^Ftr, Mdd, Mdd, Mdd, Gd^Fts, Gd, Gs, Gd, Gd, Dd, Dd^Ftd, Dd^Edpp, Dd, Dd, Hhd, Hhd, Dd, Dd, Hhd, Hhd, Hhd, Hhd, Hhd, Hhd, Dd, Hhd, Dd, Dd^Edpp, Dd, Dd^Edpp, Dd^Ftd, Dd, Gd, Gd, Gs, Gd^Fts, Gd^Fts, Gd^Fts, Gs^Ft, Gs^Ft, Mdd, Mdd, Gll^Ftr, Gll^Ftr
Gll^Ftr, Gs^Ft, Gs^Ft, Gd^Fts, Gd^Fts, Gd^Fts, Gd, Gd, Gd, Dd^Ftd, Dd, Dd, Dd^Edpp, Dd^Edpp, Dd^Ftd, Dd^Edpp, Dd^Edpp, Hhd, Hhd, Dd, Hhd, Hhd, Dd, Hhd, Dd^Edpp, Hhd, Dd^Edpp, Dd^Edpp, Gd, Dd, Gd, Gd, Gd^Fts, Gd, Gs, Gd^Fts, Mdd, Mdd, Mdd, Gs^Ft, Gll^Ftr, Gll^Ftr, Gs^Vc, Gll^Ftr
Gll^Ftr, Gs^Ft, Mdd, Mdd, Gd^Fts, Gs, Gs, Gd^Fts, Gd, Gd, Gd^Fts, Gd, Dd^Edpp, Dd, Dd, Dd, Dd, Dd^Edpp, Dd^Edpp, Dd, Dd^Edpp, Dd, Dd^Edpp, Dd^Edpp, Dd, Dd, Dd^Ftd, Dd^Ftd, Gd, Gd, Gd^Fts, Gd, Gd, Gd^Fts, Gd^Fts, Gd^Fts, Gs^Ft, Mdd, Gll^Ftr, Gll^Ftr, Gs^Ft, Gs^Vc, Gll^Ecf, Gll^Ftr
Gll^Ftr, Mdd, Mdd, Gd^Fts, Gd^Fts, Gd^Fts, Gd^Fts, Gs, Gd^Fts, Gd, Gd^Fts, Dd^Ftd, Gd, Gd, Dd, Dd, Gd, Dd^Ftd, Dd, Dd, Dd^Edpp, Dd, Gd, Dd, Dd, Gd, Gd, Dd, Gd, Gd, Gd^Fts, Gd^Fts, Gd^Fts, Gs, Mdd, Mdd, Gs^Ft, Gs^Ft, Gll^Ftr, Gll^Ftr, Gg^Efm, Gll^Ftr, Gs^Ft, Gg
Gll^Ftr, Gll^Ftr, Gll^Ftr, Mdd, Mdd, Gd^Fts, Gd^Fts, Gs, Gd^Fts, Gd^Fts, Gs, Gd, Gd^Fts, Gd, Gd, Gd, Gd, Dd^Ftd, Gd, Gd, Gd, Dd^Ftd, Dd^Ftd, Gd, Dd, Dd, Gd, Dd, Gd^Fts, Gs, Gd^Fts, Gd^Fts, Gs^Ft, Mdd, Gll^Ftr, Gll^Ftr, Gll^Ftr, Gll^Ftr, Mdd, Gs^Ft, Gs^Ft, Gg^Efm, Gg^Efm, Gll^Ftr
Gll^Ftr, Ss^Ftm, Ss^Ftm, Gll^Ftr, Gs^Ft, Gs^Ft, Gs^Ft, Gd^Fts, Mdd, Gd^Fts, Gd^Fts, Gs, Gd^Fts, Gd, Gd^Fts, Dd^Ftd, Gd^Fts, Dd, Gd, Gd^Fts, Gd, Dd, Gd, Gd, Gd^Fts, Gd, Gd^Fts, Gd, Gs, Gd^Fts, Mdd, Gs^Ft, Gs^Ft, Gs^Ft, Gg^Efm, Gs^Ft, Gs^Ft, Mdd, Mdd, Mdd, Gs^Ft, Gg^Efm, Gs^Ft, Gll^Ftr
Gll^Ftr, Gll^Ftr, Gs^Ft, Gll^Ftr, Gg^Efm, Gg^Efm, Gs^Ft, Gs^Ft, Gll^Ftr, Mdd, Mdd, Gd^Fts, Gd^Fts, Gd^Fts, Gd^Fts, Gs, Gd^Fts, Gd^Fts, Gd, Gd, Gs, Gd^Fts, Gd^Fts, Gd, Gs, Gd, Gs, Gd^Fts, Gd^Fts, Mdd, Mdd, Mdd, Mdd, Gll^Ftr, Gll^Ftr, Gg^Efm, Gs^Ft, Gll^Ftr, Gll^Ftr, Gll^Ftr, Gg^Efm, Gg^Efm, Ss^Ftm, Gll^Ftr
Gll^Ftr, Gll^Ftr, Gg^Efm, Gs^Ft, Gll^Ftr, Gs^Ft, Gs^Vc, Gll^Ftr, Gll^Ftr, Gll^Ftr, Gg^Efm, Gs^Ft, Mdd, Mdd, Mdd, Gd^Fts, Gd^Fts, Gs, Gd^Fts, Gd, Gd^Fts, Gd, Mdd, Mdd, Mdd, Gd^Fts, Gd^Fts, Gd^Fts, Mdd, Gs^Ft, Gs^Ft, Mdd, Mdd, Mdd, Gs^Ft, Gg^Efm, Gg^Efm, Gs^Ft, Gll^Ftr, Gll^Ftr, Gll^Ftr, Gg^Efm, Gll^Ftr, Gll^Ftr
Gll^Ftr, Ss^Ftm, Gg^Efm, Gg^Efm, Cdr, Gll^Ftr, Cdr, Gll^Ecf, Gll^Ftr, Gg^Efm, Gll^Ftr, Gs^Ft, Gll^Ftr, Mdd, Gs^Ft, Gs^Ft, Gs^Ft, Gd^Fts, Mdd, Gd^Fts, Gs, Gd^Fts, Gs^Ft, Mdd, Gs^Ft, Gs^Ft, Mdd, Mdd, Gll^Ftr, Mdd, Mdd, Gll^Ftr, Gll^Ftr, Gll^Ftr, Gll^Ftr, Gg^Efm, Gg^Efm, Gll^Ftr, Cdr, Gll^Ftr, Cdr, Gll^Ftr, Gll^Ftr, Gll^Ftr
Gll^Ftr, Gs^Ft, Gg^Efm, Cdr, Cdr, Kdr, Cdr, Gll^Ftr, Mdd, Mdd, Mdd, Gll^Ftr, Gg^Efm, Gll^Ftr, Gll^Ftr, Gs^Ft, Mdd, Mdd, Gs^Ft, Gd^Fts, Gd^Fts, Gd^Fts, Mdd, Gs^Ft, Gll^Ftr, Mdd, Gll^Ftr, Gll^Ftr, Ss^Ftm, Gll^Ftr, Gll^Ftr, Gll^Ftr, Gll^Ftr, Ss^Ftm, Ss^Ftm, Gs^Ft, Gll^Ftr, Cdr, Kdr, Gll^Ftr, Cdr, Gll^Ftr, Gll^Ftr, Gll^Ftr
Gs^Ft, Gg^Efm, Gs^Ft, Gll^Ftr, Cdr, Gll^Ftr, Gll^Ftr, Cdr, Gs^Ft, Mdd, Mdd, Mdd, Mdd, Gll^Ftr, Gs^Ft, Gll^Ftr, Gs^Ft, Gs^Ft, Gs^Ft, Gs^Ft, Gs^Ft, Mdd, Mdd, Mdd, Gll^Ftr, Gll^Ftr, Gs^Ft, Gll^Ftr, Gll^Ftr, Gll^Ftr, Mdd, Gll^Ftr, Gs^Ft, Gs^Ft, Gs^Vc, Gs^Ft, Gg^Efm, Gll^Ftr, Cdr, Kdr, Gll^Ftr, Gll^Ftr, Gll^Ftr, Gll^Ftr
Gg^Efm, Gg^Efm, Ss^Ftm, Ss^Ftm, Gll^Ftr, Gll^Ftr, Gll^Ftr, Gg^Efm, Gg^Efm, Gll^Ftr, Gll^Ftr, Mdd, Gs^Ft, Gll^Ftr, Gg^Efm, Gg^Efm, Gg^Efm, Gg^Efm, Gg^Efm, Gs^Ft, Gll^Ftr, Gll^Ftr, Gll^Ftr, Gll^Ftr, Gs^Ft, Gg^Efm, Gg^Efm, Gs^Ft, Gll^Ftr, Mdd, Mdd, Mdd, Gll^Ftr, Gg^Efm, Gs^Vc, Gll^Ecf, Gs^Ft, Gll^Ftr, Gll^Ftr, Cdr, Gs^Ft, Cdr, Gs^Ft, Gll^Ftr
Gs^Ft, Gs^Ft, Gll^Ftr, Ss^Ftm, Gll^Ftr, Gs^Vc, Gll^Ftr, Ss^Ftm, Gs^Ft, Gg^Efm, Gg^Efm, Gg^Efm, Gg^Efm, Gs^Ft, Gll^Ftr, Gs^Ft, Gs^Ft, Gg^Efm, Gg^Efm, Gs^Ft, Gll^Ftr, Gs^Vc, Gll^Ecf, Gs^Vc, Ss^Ftm, Gg^Efm, Gs^Ft, Gg^Efm, Gg^Efm, Gll^Ftr, Gg^Efm, Gg^Efm, Gs^Ft, Gg^Efm, Gs^Ft, Gs^Ft, Gll^Ftr, Gll^Ftr, Gll^Ftr, Gll^Ftr, Gs^Ft, Gg^Efm, Gg^Efm, Gs^Ft
Gll^Ftr, Gll^Ftr, Gll^Ftr, Gll^Ftr, Gll^Ftr, Gg^Ecf, Gll^Ftr, Gll^Ftr, Gll^Ftr, Gll^Ftr, Gll^Ftr, Ss^Ftm, Gll^Ftr, Gll^Ftr, Gll^Ftr, Gll^Ftr, Gll^Ftr, Gs^Ft, Gll^Ftr, Ss^Ftm, Gll^Ftr, Gll^Ftr, Gll^Ftr, Gll^Ftr, Gll^Ftr, Gll^Ftr, Gll^Ftr, Gs^Ft, Gll^Ftr, Gs^Ft, Gll^Ftr, Gs^Ft, Gll^Ftr, Gll^Ftr, Gll^Ftr, Gll^Ftr, Gll^Ftr, Gll^Ftr, Gll^Ftr, Gll^Ftr, Gll^Ftr, Gs^Ft, Gll^Ftr, Gg^Efm
