Wot, Wot, Wot, Wot, Wot, Wot, Wot, Wot, Wot, Wot, Wot, Wot, Wot, Wot, Wot, Wot, Wot, Wot, Wot, Wot, Wot, Wot, Wot, Wot, Wot, Wot, Wot, Wot, Wot, Wot, Wot, Wot, Wot, Wwt, Wwr, Wwt, Wwt, Wwt, Wwr, Wwt, Wot, Wot, Wot, Wot, Wot, Wot, Wot, Wot, Wot, Wot, Wot, Wot, Wot, Wot, Wot, Wot, Wot, Wot, Wot, Wot, Wot, Wot
Wot, Wot, Wot, Wot, Wot, Wot, Wot, Wot, Wot, Wot, Wot, Wot, Wot, Wot, Wot, Wot, Wot, Wot, Wot, Wot, Wot, Wot, Wot, Wot, Wot, Wot, Wot, Wot, Wot, Wot, Wot, Wot, Wwr, Wwr, Wwt, Wwt, Wwt, Wwt, Wwt, Wwr, Wwr, Wot, Wot, Wot, Wot, Wot, Wot, Wot, Wot, Wot, Wot, Wot, Wot, Wot, Wot, Wot, Wot, Wot, Wot, Wot, Wot, Wot
Wot, Wot, Wot, Wot, Wot, Wot, Wot, Wot, Wot, Wot, Wot, Wot, Wot, Wot, Wot, Wot, Wot, Wot, Wot, Wot, Wot, Wot, Wot, Wot, Wot, Wot, Wot, Wot, Wwr, Wwr, Wwr, Wwr, Wwt, Wwt, Wwrt, Ds, Wwt, Wwt, Wwt, Wwt, Wwr, Wwr, Wwr, Wwr, Wot, Wot, Wot, Wot, Wot, Wot, Wot, Wot, Wot, Wot, Wot, Wot, Wot, Wot, Wot, Wot, Wot, Wot
Wot, Wot, Wot, Wot, Wot, Wot, Wot, Wot, Wot, Wot, Wot, Wot, Wot, Wot, Wot, Wot, Wot, Wot, Wot, Wot, Wot, Wot, Wot, Wot, Wot, Wot, Wwr, Wwr, Wwt, Wwt, Wwt, Wwt, Wwt, Wwt, Wwt, Wwt, Ds^Ewsh, Wwrt, Wwrt, Wwt, Md, Mv, Md, Wwr, Wwr, Wwr, Wwr, Wot, Wot, Wot, Wot, Wot, Wot, Wot, Wot, Wot, Wot, Wot, Wot, Wot, Wot, Wot
Wot, Wot, Wot, Wot, Wwr, Wot, Wwr, Wot, Wwr, Wot, Wot, Wot, Wwr, Wot, Wwr, Wot, Wot, Wot, Wot, Wot, Wot, Wot, Wot, Wot, Wot, Wwr, Wwt, Wwt, Wwt, Wwt, Ds, Wwt, Wwrt, Ds, Dd^Ftd, Wwrt, Dd^Edp, Dd^Ftd, Dd^Ftd, Dd^Ftd, Dd, Md, Cdr, Dd, Wwt, Wwt, Wwr, Wwr, Wot, Wot, Wot, Wot, Wot, Wot, Wot, Wot, Wot, Wot, Wot, Wot, Wot, Wot
Wot, Wot, Wwr, Wwr, Wwt, Wwr, Wwt, Wwr, Ds, Wwr, Wwr, Wwr, Wwt, Wwr, Wwt, Wwr, Wwr, Wot, Wot, Wot, Wot, Wot, Wot, Wot, Wot, Wwr, Wwr, Wwt, Wwt, Wwrt, Wwt, Wwt, Wwt, Dd^Ftd, Wwt^Vm, Dd, Dd^Edp, Dd^Edp, Dd^Edp, Dd^Do, Dd^Ftd, Dd^Ftd, Kdr, Wwrt, Wwt, Wwt, Wwr, Wot, Wwr, Wot, Wwr, Wot, Wot, Wot, Wot, Wot, Wot, Wot, Wot, Wot, Wot, Wot
Wwr, Wwr, Wwt, Wwt, Wwt, Wwt, Wwt, Wwt, Wwt, Wwt, Wwt, Wwt, Dd^Ftd, Wwt, Wwt, Wwt, Wwt, Wwr, Wwr, Wot, Wot, Wot, Wot, Wot, Wot, Wot, Wwr, Wwt, Wwt, Wwt, Ds, Wwrt, Ds^Ewsh, Wwt, Wwrt, Dd, Mdd, Mdd, Mdd, Dd, Dd^Ftd, Cdr, Wwrt, Wwt, Wwrt, Wwt, Wwt, Wwr, Wwt, Wwr, Wwr, Wwr, Wot, Wot, Wot, Wot, Wot, Wot, Wot, Wot, Wot, Wot
Wwr, Wwt, Ds, Wwrt, Wwrt, Wwt, Wwt, Wwt, Wwt, Dd^Ftd, Ds, Hd, Wwrt, Wwrt, Wwt, Wwt, Wwt, Wwt, Wwt, Wwr, Wwr, Wot, Wot, Wot, Wot, Wot, Wwr, Wwt, Wwt, Ds^Ewsh, Dd^Ftd, Ds, Dd, Wwrt, Wwt, Wwt, Hd, Mdd, Mdd, Mdd, Dd, Ds, Wwt, Wwt, Ds, Wwt, Wwt, Wwt, Wwt, Wwt, Wwr, Wot, Wwr, Wwr, Wot, Wot, Wot, Wot, Wot, Wot, Wot, Wot
Wwr, Wwt, Wwt, Dd^Ftd, Ds, Wwt, Wwt, Wwt, Ds, Wwt, Wwrt, Ds, Hd^Edp, Wwrt, Wwrt, Wwt, Wwt, Wwt, Ds^Ewsh, Wwt, Wwt, Wwr, Wwr, Wwr, Wwr, Wwrt, Wwt, Wwt, Wwt, Ds, Ds, Dd, Cdr, Cdr, Hd^Edp, Wwt, Wwrt, Dd, Dd, Cdr, Wwt, Wwrt, Dd, Wwrt, Wwrt, Wwt, Wwt, Wwt, Wwt, Wwt, Wwt, Wwr, Wwt, Wwr, Wot, Wwr, Wwr, Wot, Wot, Wot, Wot, Wot
Wot, Wwr, Wwr, Ds, Wwt, Wwt, Wwt, Wwt, Wwt, Wwrt, Dd, Dd, Dd^Edp, Ds, Ds^Ewsh, Wwt, Wwrt, Wwrt, Ds, Dd^Ftd, Ds^Ewsh, Wwt, Wwt, Wwt, Wwt, Wwt, Wwt, Wwt, Ds, Wwrt, Dd, Hd^Edp, Dd, Mdd, Mdd, Wwt, Dd, Wwrt, Wwt, Mdd, Wwt, Wwt, Mdd, Dd, Dd^Ftd, Dd^Ftd, Dd^Ftd, Ds, Wwt, Wwt, Wwt, Wwt, Wwt, Wwr, Wwr, Wwr, Wwt, Wwr, Wot, Wot, Wot, Wot
Wot, Wot, Wwr, Wwt, Wwt, Wwt, Wwt, Wwt, Cdr, Wwt, Wwt, Hd^Edp, Wwrt, Dd^Ftd, Ds, Wwrt, Wwt, Wwt, Wwrt, Ds, Ds^Ewsh, Wwrt, Wwt, Wwt, Wwt, Wwt, Wwrt, Wwt, Ds, Dd^Ftd, Dd, Dd^Edp, Md, Mv, Md, Mdd, Mdd, Mdd, Mdd, Wwf, Wwrt, Wwrt, Dd^Ftd, Mdd, Dd^Edp, Dd, Wwt, Wwt, Wwrt, Wwt, Wwt, Wwt, Wwt, Wwt, Wwt, Wwt, Wwt, Wwr, Wwr, Wot, Wot, Wot
Wot, Wot, Wot, Wwr, Wwt, Wwt, Wwrt, Wwrt, Kdr, Wwt, Wwt, Ds, Wwt, Wwrt, Wwt, Ds, Wwt, Wwt, Wwt, Wwrt, Wwt, Ds, Wwt, Wwt, Wwt, Wwrt, Wwt, Wwt, Wwt, Dd^Ftd, Dd^Ftd, Dd^Do, Dd^Edp, Md, Mdd, Mdd, Wwt^Vm, Mdd, Wwt, Wwf, Wwrt, Wwt, Dd, Dd, Hd^Edp, Wwt, Wwrt, Wwt, Dd^Ftd, Ds^Ewsh, Wwrt, Wwrt, Wwt^Vm, Wwt, Wwt, Wwt, Wwt, Wwt, Wwt, Wwr, Wot, Wot
Wot, Wot, Wwr, Wwr, Wwt, Wwt, Cdr, Cdr, Hd, Cdr, Wwt, Wwt, Wwt, Wwt, Wwt, Wwt, Dd^Ftd, Wwt, Wwt, Wwrt, Wwt, Wwt, Wwt, Wwt, Dd^Ftd, Wwt, Wwt, Wwt, Wwt, Wwt, Wwt, Dd, Dd, Dd^Edp, Dd, Dd, Wwt, Wwt, Wwt, Hd, Dd, Wwt, Wwf, Ds, Hd, Wwt, Wwrt, Dd, Dd, Ds, Dd^Ftd, Dd^Ftd, Dd, Dd^Ftd, Ds, Wwt, Wwt, Wwt, Wwt, Wwr, Wot, Wot
Wwr, Wwr, Wwt, Wwt, Dd^Ftd, Wwrt, Ds^Vdt, Dd^Ftd, Dd^Ftd, Cdr, Wwt, Wwt, Wwt, Wwt, Wwt, Wwt, Wwrt, Dd^Ftd, Ds, Ds, Wwrt, Wwt, Wwt, Ds, Ds, Wwr, Wwt, Wwt, Wwt, Wwr, Cdr, Dd^Ftd, Dd^Ftd, Dd^Ftd, Wwt, Wwt, Dd, Dd, Md, Mv, Md, Dd, Wwf, Hd, Wwt, Wwt, Dd, Dd, Cdr, Dd, Dd^Edp, Dd, Dd, Dd^Ftd, Wwt, Wwt, Wwt, Wwt, Wwt, Wwr, Wot, Wot
Wwt, Wwt, Wwt, Ds, Hd^Edp, Ds, Dd^Vdt, Dd, Ds^Vdt, Wwrt, Wwt, Wwt, Wwt, Wwt, Dd^Ftd, Wwrt, Wwrt, Dd, Hd, Dd^Ftd, Ds, Wwt, Wwt, Wwt, Wwt, Wwt, Wwt, Wwt, Wwt, Wwt, Wwt, Ds^Ewsh, Ds, Wwrt, Wwrt, Dd^Ftd, Dd, Mdd, Mdd, Md, Hd^Edp, Dd, Wwt, Wwt, Dd, Ds^Ewsh, Mdd, Mdd, Mdd, Dd, Cdr, Dd^Edp, Dd^Ftd, Ds, Dd^Ftd, Wwt, Wwt, Wwt, Wwt, Wwr, Wot, Wot
Wwt, Wwt, Wwt, Ds, Dd^Ftd, Dd, Ds, Ds, Wwt, Wwt, Ds, Wwrt, Wwt, Wwt, Ds, Ds^Ewsh, Ds, Ds, Hd, Dd^Ftd, Wwrt, Wwt, Wwt, Wwt, Wwrt, Dd, Dd^Do, Wwrt, Wwt, Wwt, Wwt, Wwt, Wwt, Wwt, Cdr, Dd^Ftd, Cdr, Dd^Edp, Dd^Do, Dd^Edp, Hd, Wwrt, Wwt, Wwt, Dd^Ftd, Dd^Ftd, Md, Mv, Md, Dd^Ftd, Wwf, Hd, Wwrt, Dd, Dd^Ftd, Ds, Wwt, Wwt, Wwr, Wwr, Wot, Wot
Wwr, Wwt, Wwt, Wwt, Ds, Dd, Wwt, Wwt, Wwrt, Dd^Edp, Dd, Wwrt, Ds, Wwt, Dd, Ds, Wwrt, Ds, Wwt, Ds, Wwt, Wwt, Ww, Wwt, Wwt, Ds, Ds, Wwrt, Ww, Ww, Wwt, Wwt, Wwt, Ds, Wwt, Kdr, Wwrt, Cdr, Dd, Dd, Wwt, Wwrt, Hd, Wwrt, Wwt, Dd^Ftd, Mdd, Md, Mdd, Wwf, Ds, Wwf, Wwrt, Wwt, Wwt, Dd^Ftd, Wwrt, Wwt, Wwr, Wot, Wot, Wot
Wot, Wwr, Wwr, Wwt, Wwt, Wwt, Wwt, Wwt, Wwrt, Dd^Ftd, Dd^Ftd, Hd, Hd, Dd^Edp, Dd, Ds, Wwt, Wwt, Wwt, Wwt, Wwr, Wwr, Wot, Ww, Ww, Ww, Ww, Ww, Wwt, Wwt, Wwr, Wwt, Wwt, Wwt, Wwt, Cdr, Wwt, Wwrt, Ds, Wwrt, Dd, Dd^Edp, Wwt^Vm, Wwt, Dd, Wwt, Wwt, Mdd, Wwrt, Wwf, Wwf, Wwt^Vm, Wwrt, Dd^Ftd, Ds, Wwrt, Wwt, Wwt, Wwr, Wot, Wot, Wot
Wot, Wot, Wwt, Wwt, Wwt, Wwt, Wwt, Wwt, Wwt, Wwrt, Ds, Dd^Ftd, Ds, Ds, Wwt, Ds, Wwt, Wwt, Wwt, Wwr, Wot, Wot, Wot, Wot, Ww, Ww, Ww, Ww, Ww, Wot, Wot, Wwr, Wwr, Wwt, Wwt, Wwt, Wwt, Wwt, Wwt, Wwrt, Ds^Ewsh, Dd, Wwrt, Ds, Dd^Ftd, Dd, Dd, Wwrt, Dd, Hd, Dd^Ftd, Wwf, Dd, Dd^Ftd, Ds, Ds, Wwt, Wwt, Wwt, Wwr, Wot, Wot
Wot, Wot, Wot, Wwt, Wwr, Wwt, Wwt, Wwt, Wwt, Wwt, Wwt, Wwt, Wwt, Wwt, Wwt, Wwt, Wwr, Wwt, Wot, Wot, Wot, Wot, Wot, Wot, Ww, Ww, Dd^Edp, Ww, Ww, Wot, Wot, Wot, Wot, Wwr, Wwr, Wwt, Wwt, Wwt, Wwt, Wwt, Wwt, Wwt, Wwrt, Wwrt, Wwrt, Dd^Ftd, Dd^Ftd, Dd^Ftd, Wwt^Vm, Dd^Ftd, Ds, Dd^Edp, Dd^Ftd, Ds, Wwt, Ds, Wwt, Wwt, Wwr, Wwr, Wot, Wot
Wot, Wot, Wot, Wot, Wot, Wwt, Wwt, Wwt, Wwr, Wwt, Wwt, Wwt, Wwr, Wwr, Wot, Wwt, Wot, Wot, Wot, Wot, Wwt, Wot, Wwr, Wwr, Ww, Ww, Dd, Ww^Vm, Ww, Wwr, Wwr, Wot, Wot, Wot, Wot, Wot, Wot, Wwt, Wwt, Wwt, Wwt, Wwt, Wwt, Wwrt, Wwt, Ds, Ds^Ewsh, Ds, Wwrt, Ds, Dd^Ftd, Cdr, Kdr, Wwrt, Cdr, Wwt, Wwt, Wwt, Wwr, Wot, Wot, Wot
Wot, Wot, Wot, Wot, Wot, Wot, Wot, Wot, Wot, Wwr, Wot, Wwt, Wot, Wot, Wot, Wot, Wwr, Wot, Wwr, Wwt, Wwt, Wwr, Wwt, Wwt, Wwt, Wwt, Wwt, Wwt, Wwt, Wwt, Wwt, Wwr, Wwr, Wot, Wot, Wot, Wot, Wwr, Wwr, Wwt, Wwt, Wwt, Wwt, Wwt, Wwt, Wwt, Wwt, Wwt, Wwt, Ds, Wwt, Wwrt, Ds, Cdr, Cdr, Ds, Wwt, Wwr, Wot, Wwr, Wot, Wot
Wot, Wot, Wot, Wot, Wot, Wot, Wot, Wot, Wot, Wot, Wot, Wot, Wwr, Wot, Wwt, Wwt, Wwt, Wwr, Wwt, Wwt, Wwt, Wwt, Ds, Wwt, Ds, Wwt, Wwt, Wwt, Wwrt, Wwt, Wwt, Wwt, Wwt, Wwt, Wwt, Wot, Wot, Wot, Wot, Wwr, Wwr, Wwr, Wwr, Wwt, Wwr, Wwr, Wwr, Wwt, Ww, Cdr, Wwt, Wwt, Wwt, Wwrt, Ds, Ds, Wwt, Wwr, Wwr, Wot, Wot, Wot
Wot, Wot, Wot, Wot, Wwt, Wwr, Wwt, Wwt, Wwr, Wwr, Wwr, Wwt, Wwt, Wwr, Wwt, Wwt, Wwt, Wwt, Ds, Ds, Dd^Ftd, Ds^Ewsh, Ds, Wwt, Ds, Dd^Ftd, Dd^Ftd, Wwrt, Ds, Wwrt, Ds, Ds, Ds, Wwt, Wwt, Wwt, Wwr, Wot, Wot, Wot, Wot, Wot, Wot, Wwr, Wot, Wot, Wot, Wwr, Ww, Ww, Ww, Wwt, Wwt, Wwt, Wwt, Wwt, Wwt, Wwt, Wwr, Wot, Wot, Wot
Wot, Wot, Wot, Wwr, Wwt, Wwt, Wwt, Wwt, Wwt, Wwt, Wwt, Wwt, Ds, Wwt, Wwt, Wwt, Wwrt, Ds, Gs^Ft, Gs^Ft, Gll^Ftr, Ds, Gs^Ftr, Wwf, Gs^Ftr, Gs^Ft, Ds, Ds, Ds^Ewsh, Ds, Gs^Ftp, Ds, Ds, Ds, Ds, Wwt, Wwt, Wwr, Wwr, Wot, Wwr, Wot, Wwr, Wot, Wwr, Wot, Wwr, Ww, Ww, Ww, Ww, Wwr, Wwr, Wwt, Wwt, Wwt, Wwt, Wwt, Wwr, Wot, Wot, Wot
Wot, Wot, Wwr, Wwr, Wwt, Wwt, Ds, Wwt, Ds, Ds, Ds, Wwt, Ds^Ewsh, Ds^Ewsh, Ds, Ds, Dd^Ftd, Dd^Ftd, Gll^Ftr, Gll^Ftr, Gs^Ftp, Gs^Ftp, Gg^Efm, Wwf, Gs^Ftr, Gll^Vo, Gg^Efm, Gs, Gs^Ft, Gs^Ftp, Gs^Ft, Gs^Ftp, Ds, Ds^Ewsh, Ds, Wwt, Wwt, Wwt, Wwt, Wwr, Wwt, Wwr, Wwt, Wwr, Wwt, Wwr, Wwt, Ww, Wwr, Ww, Wwr, Wot, Wot, Wwr, Wwr, Wwt, Wwr, Wwr, Wot, Wot, Wot, Wot
Wot, Wwr, Wwt, Wwt, Wwrt, Ds, Gs^Ft, Dd^Ftd, Gs^Ftp, Gs^Ft, Ds, Wwf, Ds, Ds, Ds, Ds, Gll^Ftr, Gll^Ftr, Ss^Ftm, Gll^Ftr, Gs^Ftp, Gll^Ftr, Gs^Ftp, Wwf, Co, Gs, Gll^Ecf, Gg^Vo, Gs, Gs^Ftp, Sm, Gs^Ftp, Ds, Ds, Wwrt, Wwrt, Wwt, Wwt, Wwt, Wwt, Wwt, Wwt, Wwt, Wwt, Wwrt, Wwt, Ds, Wwt, Wwt, Wwr, Wwt, Wwr, Wwr, Wot, Wot, Wwr, Wwr, Wot, Wot, Wot, Wot, Wot
Wwt, Wwt, Wwt, Wwrt, Ds, Ds, Ds, Gs^Ftp, Gll^Ftr, Gs^Ftr, Wwrt, Wwf, Gs^Ft, Gs^Ft, Gg^Efm, Gll^Ftr, Gll^Ftr, Gll^Ftr, Gs^Ft, Gs^Ft, Gs^Ftp, Gll^Ftr, Re, Wwt^Bw/, Co, Co, Gs^Ftp, Gs, Ss^Ftm, Sm, Ss^Ftm, Sm, Mdd, Ds, Ds, Wwrt, Wwt, Wwt, Wwt, Wwt, Ds, Dd^Vht, Dd^Ftd, Mdd, Dd^Ftd, Dd, Gs^Ft, Mdd, Gs^Ftp, Ds, Wwrt, Wwt, Wwr, Wot, Wot, Wot, Wot, Wot, Wot, Wot, Wot, Wot
Wwt, Wwt, Wwt, Wwrt, Dd^Ftd, Ds, Ds, Ds, Ds^Ftp, Gs^Ftr, Wwf, Wwf, Gg^Efm, Gg^Efm, Gg^Efm, Gs^Ft, Gs^Ftp, Gs^Vo, Gll^Ecf, Gs, Re, Re, Gs^Ftr, Wwt, Wwrt, Ko, Gll^Ftr, Ss, Ss, Ss^Ewf, Ss, Sm, Mdd, Mdd, Wwt, Wwt, Wwt, Wwt, Wwt, Wwt, Gs^Ft, Gs^Ftp, Gll^Ftr, Gs^Ft, Gs^Ft, Gs^Ft, Mv, Gs^Ft, Dd^Vht, Ds, Wwrt, Wwt, Wwt, Wwr, Wwr, Wot, Wot, Wot, Wot, Wot, Wot, Wot
Wwt, Wwt, Ds, Dd^Ftd, Ds, Ds, Gs^Ftp, Ds, Gs^Ft, Gs^Vo, Wwt, Gs^Ftr, Gll^Ftr, Gs^Ft, Gll^Ftr, Gll^Ftr, Gll^Ftr, Gs^Vo, Re, Re, Gll^Ftr, Gs^Ftp, Gs^Ftr, Wwt, Wwt, Co, Gs^Ftp, Sm, Sm, Ss, Ss^Ftm, Ss, Wwf, Wwrt, Wwt, Wwt, Wwt, Wwt, Wwt, Ds, Dd^Ftd, Gs^Ftp, Mdd, Gs^Ft, Dd^Ftd, Md, Md, Md, Dd, Wwt, Wwt, Wwrt, Wwt, Wwt, Wwt, Wwr, Wot, Wot, Wot, Wot, Wot, Wot
Mdd^Qhux, Ds, Gs^Ft, Gs^Ft, Gll^Ftr, Ds, Gll^Ftr, Ds, Gll^Vo, Gs^Ecf, Wwt^Bw/, Re, Re, Re, Re, Re, Re, Re, Gll^Ftr, Gll^Ftr, Ss^Ftm, Gll^Ftr, Ss^Ftm, Gs^Ftr, Gs^Ftr, Wwrt, Mdd^Qhux, Mdd^Qhux, Mdd^Qhux, Sm, Sm, Wwf, Wwrt, Wwrt, Wwt, Wwt, Wwt, Wwt, Wwt, Wwt, Ds, Ds, Wwrt, Dd^Vht, Ds, Dd, Ds, Ds, Wwrt, Wwt, Wwt, Wwt, Wwt, Wwt, Wwt, Wwr, Wot, Wot, Wot, Wot, Wot, Wot
Hd^Qhux, Mdd^Qhux, Mdd^Qhux, Gll^Ftr, Mdd^Qhux, Gll^Ftr, Gll^Ftr, Gll^Ftr, Gll^Ftr, Re, Wwt, Wwt, Gs^Ft, Ss^Ftm, Gs^Ft, Ss^Ftm, Gll^Vo, Gs, Gg^Efm, Ss^Ftm, Gll^Ftr, Ss^Ftm, Mdd^Qhux, Mdd^Qhux, Mdd^Qhux, Mdd^Qhux, Dd^Qhux, Mdd^Qhux, Dd^Qhux, Mdd^Qhux, Mdd^Qhux, Mdd^Qhux, Wwt, Wwt, Wwt, Wot, Wwt, Wwt, Wwr, Wwt, Wwt, Wwt, Wwt, Wwrt, Wwt, Wwrt, Wwrt, Wwt, Wwrt, Ds, Wwt, Wwt, Wwt, Wwt, Wwr, Wwr, Wot, Wot, Wot, Wot, Wot, Wot
Hd^Qhux, Dd^Qhux, Hd^Qhux, Mdd^Qhux, Dd^Qhux, Mdd^Qhux, Mdd^Qhux, Gll^Ftr, Ss^Ftm, Gs^Ftr, Wwt, Gs^Ftr, Gs^Ft, Gs^Ft, Gs^Ft, Gll^Ftr, Gs, Gll^Ecf, Gs, Gll^Ftr, Gll^Ftr, Gll^Ftr, Mdd^Qhux, Mdd^Qhux, Dd^Qhux, Dd^Qhux, Dd^Qhux, Dd^Qhux, Dd^Qhux, Dd^Qhux, Dd^Qhux, Mdd^Qhux, Wwt, Wwt, Wwr, Wot, Wot, Wwr, Wot, Wwr, Wwr, Wwt, Wwt, Wwt, Wwt, Ds, Wwt, Wwrt, Ds, Wwt, Wwt, Wwt, Wwr, Wwr, Wot, Wot, Wot, Wot, Wot, Wot, Wot, Wot
Dd^Qhux, Dd^Qhux, Dd^Qhux, Dd^Qhux, Dd^Qhux, Hd^Qhux, Dd^Qhux, Mdd^Qhux, Mdd^Qhux, Wwt, Gs^Ft, Gll^Ftr, Gs^Ft, Gs^Ft, Gs^Ft, Gs^Ftp, Gs^Ft, Gs, Mdd^Qhux, Mdd^Qhux, Mdd^Qhux, Mdd^Qhux, Hd^Qhux, Dd^Qhux, Dd^Qhux, Hd^Qhux, Hd^Qhux, Hd^Qhux, Hd^Qhux, Hd^Qhux, Dd^Qhux, Mdd^Qhux, Mdd^Qhux, Wwt, Wwr, Wwr, Wot, Wot, Wot, Wot, Wot, Wwr, Wwr, Wwt, Wwt, Wwt, Wwt, Wwt, Wwt, Wwt, Wwt, Wwt, Wwr, Wot, Wot, Wot, Wot, Wot, Wot, Wot, Wot, Wot
Hd, Hd, Hd, Dd^Qhux, Hd, Dd^Qhux, Dd^Qhux, Dd^Qhux, Dd^Qhux, Mdd^Qhux, Mdd^Qhux, Gs^Ft, Gs^Ft, Gs^Ft, Gs^Ft, Gs^Ft, Gs^Ft, Gs^Ft, Mdd^Qhux, Mdd^Qhux, Mdd^Qhux, Hd^Qhux, Hd^Qhux, Dd^Ftd, Dd^Qhux, Hd^Qhux, Dd^Qhux, Dd^Qhux, Dd^Qhux, Dd^Qhux, Dd^Qhux, Dd^Qhux, Mdd^Qhux, Wwt, Wwt, Wot, Wot, Wot, Wot, Wot, Wot, Wot, Wwt, Wwt, Wwt, Wwt, Wwt, Wwt, Wwt, Wwt, Wwt, Wwt, Wwt, Wot, Wot, Wot, Wot, Wot, Wot, Wot, Wot, Wot
