Xoi, Xoi, Xoi, Xoi, Xoi, Xoi, Xoi, Xoi, Xoi, Xoi, Xoi, Xoi, Xoi, Xoi, Xoi, Xoi, Xoi
Xoi, Xoi, Xoi, Xoi, Xoi, Xoi, Xoi, Xoi, Xoi, Xoi, Xoi, Xoi, Xoi, Xoi, Xoi, Xoi, Xoi
Xoi, Xoi, Xoi, Xoi, Xoi, Xoi, Xoi, Xoi, Xoi, Xoi, Xoi, Xoi, Xoi, Xoi, Xoi, Xoi, Xoi
Xoi, Xoi, Xoi, Xoi, Xoi, Xoi, Icr, Icr, Icn, Icr, Icr, Xoi, Xoi, Xoi, Xoi, Xoi, Xoi
Xoi, Xoi, Xoi, Xoi, Xoi, Irs, Icr, Icr, Icr, Icr, Icr, Irs, Xoi, Xoi, Xoi, Xoi, Xoi
Xoi, Xoi, Xoi, Xoi, Irs^Ebn, Irs, Irs, Icr, Irs, Icr, Irs, Irs, Irs^Ebn, Xoi, Xoi, Xoi, Xoi
Xoi, Xoi, Xoi, Xoi, Irs, Irs, Iwr, Irs, Iwr, Irs, Iwr, Irs, Irs, Xoi, Xoi, Xoi, Xoi
Xoi, Xoi, Xoi, Xoi, Irs, Xoi, Irs, Irs, Irs, Irs, Irs, Xoi, Irs, Xoi, Xoi, Xoi, Xoi
Xoi, Xoi, Xoi, Xoi, Irs^Ebn, Irs, Irs, Iwr, Irs, Iwr, Irs, Irs, Irs^Ebn, Xoi, Xoi, Xoi, Xoi
Xoi, Xoi, Xoi, Xoi, Irs, Xoi, Iwr, Irs, Iwr, Irs, Iwr, Xoi, Irs, Xoi, Xoi, Xoi, Xoi
Xoi, Xoi, Xoi, Xoi, Xoi, Irs, Irs^Ebn, Irs, Irs, Irs, Irs^Ebn, Irs, Xoi, Xoi, Xoi, Xoi, Xoi
Xoi, Xoi, Xoi, Xoi, Xoi, Xoi, Xoi, Xoi, Irs, Xoi, Xoi, Xoi, Xoi, Xoi, Xoi, Xoi, Xoi
Xoi, Xoi, Xoi, Xoi, Xoi, Xoi, Xoi, Xoi, Irs, Xoi, Xoi, Xoi, Xoi, Xoi, Xoi, Xoi, Xoi
